county,total,state_lab,other_lab,fips,timestamp
Adair,11,0,11,29001,2020-04-08T01:16:01Z
Andrew,0,0,0,29003,2020-04-08T01:16:01Z
Atchison,1,1,0,29005,2020-04-08T01:16:01Z
Audrain,0,0,0,29007,2020-04-08T01:16:01Z
Barry,1,0,1,29009,2020-04-08T01:16:01Z
Barton,0,0,0,29011,2020-04-08T01:16:01Z
Bates,3,0,3,29013,2020-04-08T01:16:01Z
Benton,3,0,3,29015,2020-04-08T01:16:01Z
Bollinger,2,0,2,29017,2020-04-08T01:16:01Z
Boone,77,5,72,29019,2020-04-08T01:16:01Z
Buchanan,14,6,8,29021,2020-04-08T01:16:01Z
Butler,5,0,5,29023,2020-04-08T01:16:01Z
Caldwell,1,0,1,29025,2020-04-08T01:16:01Z
Callaway,19,1,18,29027,2020-04-08T01:16:01Z
Camden,24,3,21,29029,2020-04-08T01:16:01Z
Cape Girardeau,20,1,19,29031,2020-04-08T01:16:01Z
Carroll,0,0,0,29033,2020-04-08T01:16:01Z
Carter,3,1,2,29035,2020-04-08T01:16:01Z
Cass,25,3,22,29037,2020-04-08T01:16:01Z
Cedar,7,0,7,29039,2020-04-08T01:16:01Z
Chariton,4,0,4,29041,2020-04-08T01:16:01Z
Christian,17,4,13,29043,2020-04-08T01:16:01Z
Clark,1,1,0,29045,2020-04-08T01:16:01Z
Clay,37,0,37,29047,2020-04-08T01:16:01Z
Clinton,8,0,8,29049,2020-04-08T01:16:01Z
Cole,32,3,29,29051,2020-04-08T01:16:01Z
Cooper,2,0,2,29053,2020-04-08T01:16:01Z
Crawford,3,0,3,29055,2020-04-08T01:16:01Z
Dade,0,0,0,29057,2020-04-08T01:16:01Z
Dallas,1,0,1,29059,2020-04-08T01:16:01Z
Daviess,0,0,0,29061,2020-04-08T01:16:01Z
DeKalb,1,0,1,NA,2020-04-08T01:16:01Z
Dent,0,0,0,29065,2020-04-08T01:16:01Z
Douglas,0,0,0,29067,2020-04-08T01:16:01Z
Dunklin,8,0,8,29069,2020-04-08T01:16:01Z
Franklin,35,0,35,29071,2020-04-08T01:16:01Z
Gasconade,2,0,2,29073,2020-04-08T01:16:01Z
Gentry,1,0,1,29075,2020-04-08T01:16:01Z
Greene,67,20,47,29077,2020-04-08T01:16:01Z
Grundy,0,0,0,29079,2020-04-08T01:16:01Z
Harrison,4,0,4,29081,2020-04-08T01:16:01Z
Henry,2,1,1,29083,2020-04-08T01:16:01Z
Hickory,0,0,0,29085,2020-04-08T01:16:01Z
Holt,0,0,0,29087,2020-04-08T01:16:01Z
Howard,1,0,1,29089,2020-04-08T01:16:01Z
Howell,4,0,4,29091,2020-04-08T01:16:01Z
Iron,0,0,0,29093,2020-04-08T01:16:01Z
Jackson,154,10,144,29095,2020-04-08T01:16:01Z
Jasper,9,2,7,29097,2020-04-08T01:16:01Z
Jefferson,92,10,82,29099,2020-04-08T01:16:01Z
Johnson,33,1,32,29101,2020-04-08T01:16:01Z
Joplin,3,1,2,NA,2020-04-08T01:16:01Z
Kansas City,219,2,217,NA,2020-04-08T01:16:01Z
Knox,0,0,0,29103,2020-04-08T01:16:01Z
Laclede,0,0,0,29105,2020-04-08T01:16:01Z
Lafayette,28,0,28,29107,2020-04-08T01:16:01Z
Lawrence,0,0,0,29109,2020-04-08T01:16:01Z
Lewis,0,0,0,29111,2020-04-08T01:16:01Z
Lincoln,21,2,19,29113,2020-04-08T01:16:01Z
Linn,3,0,3,29115,2020-04-08T01:16:01Z
Livingston,1,0,1,29117,2020-04-08T01:16:01Z
Macon,2,0,2,29121,2020-04-08T01:16:01Z
Madison,1,0,1,29123,2020-04-08T01:16:01Z
Maries,2,0,2,29125,2020-04-08T01:16:01Z
Marion,0,0,0,29127,2020-04-08T01:16:01Z
McDonald,3,0,3,NA,2020-04-08T01:16:01Z
Mercer,0,0,0,29129,2020-04-08T01:16:01Z
Miller,0,0,0,29131,2020-04-08T01:16:01Z
Mississippi,0,0,0,29133,2020-04-08T01:16:01Z
Moniteau,4,0,4,29135,2020-04-08T01:16:01Z
Monroe,0,0,0,29137,2020-04-08T01:16:01Z
Montgomery,5,0,5,29139,2020-04-08T01:16:01Z
Morgan,1,0,1,29141,2020-04-08T01:16:01Z
New Madrid,5,0,5,29143,2020-04-08T01:16:01Z
Newton,6,3,3,29145,2020-04-08T01:16:01Z
Nodaway,2,0,2,29147,2020-04-08T01:16:01Z
Oregon,1,0,1,29149,2020-04-08T01:16:01Z
Osage,4,0,4,29151,2020-04-08T01:16:01Z
Ozark,0,0,0,29153,2020-04-08T01:16:01Z
Pemiscot,3,0,3,29155,2020-04-08T01:16:01Z
Perry,28,15,13,29157,2020-04-08T01:16:01Z
Pettis,3,0,3,29159,2020-04-08T01:16:01Z
Phelps,1,0,1,29161,2020-04-08T01:16:01Z
Pike,2,1,1,29163,2020-04-08T01:16:01Z
Platte,17,0,17,29165,2020-04-08T01:16:01Z
Polk,1,0,1,29167,2020-04-08T01:16:01Z
Pulaski,12,1,11,29169,2020-04-08T01:16:01Z
Putnam,0,0,0,29171,2020-04-08T01:16:01Z
Ralls,1,1,0,29173,2020-04-08T01:16:01Z
Randolph,7,0,7,29175,2020-04-08T01:16:01Z
Ray,7,1,6,29177,2020-04-08T01:16:01Z
Reynolds,2,1,1,29179,2020-04-08T01:16:01Z
Ripley,2,0,2,29181,2020-04-08T01:16:01Z
Saline,5,0,5,29195,2020-04-08T01:16:01Z
Schuyler,0,0,0,29197,2020-04-08T01:16:01Z
Scotland,1,0,1,29199,2020-04-08T01:16:01Z
Scott,10,2,8,29201,2020-04-08T01:16:01Z
Shannon,0,0,0,29203,2020-04-08T01:16:01Z
Shelby,1,1,0,29205,2020-04-08T01:16:01Z
St. Charles,221,22,199,29183,2020-04-08T01:16:01Z
St. Clair,0,0,0,29185,2020-04-08T01:16:01Z
St. Francois,19,4,15,29187,2020-04-08T01:16:01Z
St. Louis City,399,19,380,29510,2020-04-08T01:16:01Z
St. Louis,1203,56,1147,29189,2020-04-08T01:16:01Z
Ste. Genevieve,6,1,5,29186,2020-04-08T01:16:01Z
Stoddard,8,2,6,29207,2020-04-08T01:16:01Z
Stone,3,1,2,29209,2020-04-08T01:16:01Z
Sullivan,0,0,0,29211,2020-04-08T01:16:01Z
Taney,7,1,6,29213,2020-04-08T01:16:01Z
Texas,0,0,0,29215,2020-04-08T01:16:01Z
Vernon,0,0,0,29217,2020-04-08T01:16:01Z
Warren,11,0,11,29219,2020-04-08T01:16:01Z
Washington,0,0,0,29221,2020-04-08T01:16:01Z
Wayne,0,0,0,29223,2020-04-08T01:16:01Z
Webster,3,0,3,29225,2020-04-08T01:16:01Z
Worth,1,0,1,29227,2020-04-08T01:16:01Z
Wright,7,1,6,29229,2020-04-08T01:16:01Z
TBD,1,0,1,NA,2020-04-08T01:16:01Z
Adair,11,0,11,29001,2020-04-07T21:16:01Z
Andrew,0,0,0,29003,2020-04-07T21:16:01Z
Atchison,1,1,0,29005,2020-04-07T21:16:01Z
Audrain,0,0,0,29007,2020-04-07T21:16:01Z
Barry,1,0,1,29009,2020-04-07T21:16:01Z
Barton,0,0,0,29011,2020-04-07T21:16:01Z
Bates,3,0,3,29013,2020-04-07T21:16:01Z
Benton,3,0,3,29015,2020-04-07T21:16:01Z
Bollinger,2,0,2,29017,2020-04-07T21:16:01Z
Boone,77,5,72,29019,2020-04-07T21:16:01Z
Buchanan,14,6,8,29021,2020-04-07T21:16:01Z
Butler,5,0,5,29023,2020-04-07T21:16:01Z
Caldwell,1,0,1,29025,2020-04-07T21:16:01Z
Callaway,19,1,18,29027,2020-04-07T21:16:01Z
Camden,24,3,21,29029,2020-04-07T21:16:01Z
Cape Girardeau,20,1,19,29031,2020-04-07T21:16:01Z
Carroll,0,0,0,29033,2020-04-07T21:16:01Z
Carter,3,1,2,29035,2020-04-07T21:16:01Z
Cass,25,3,22,29037,2020-04-07T21:16:01Z
Cedar,7,0,7,29039,2020-04-07T21:16:01Z
Chariton,4,0,4,29041,2020-04-07T21:16:01Z
Christian,17,4,13,29043,2020-04-07T21:16:01Z
Clark,1,1,0,29045,2020-04-07T21:16:01Z
Clay,37,0,37,29047,2020-04-07T21:16:01Z
Clinton,8,0,8,29049,2020-04-07T21:16:01Z
Cole,32,3,29,29051,2020-04-07T21:16:01Z
Cooper,2,0,2,29053,2020-04-07T21:16:01Z
Crawford,3,0,3,29055,2020-04-07T21:16:01Z
Dade,0,0,0,29057,2020-04-07T21:16:01Z
Dallas,1,0,1,29059,2020-04-07T21:16:01Z
Daviess,0,0,0,29061,2020-04-07T21:16:01Z
DeKalb,1,0,1,NA,2020-04-07T21:16:01Z
Dent,0,0,0,29065,2020-04-07T21:16:01Z
Douglas,0,0,0,29067,2020-04-07T21:16:01Z
Dunklin,8,0,8,29069,2020-04-07T21:16:01Z
Franklin,35,0,35,29071,2020-04-07T21:16:01Z
Gasconade,2,0,2,29073,2020-04-07T21:16:01Z
Gentry,1,0,1,29075,2020-04-07T21:16:01Z
Greene,67,20,47,29077,2020-04-07T21:16:01Z
Grundy,0,0,0,29079,2020-04-07T21:16:01Z
Harrison,4,0,4,29081,2020-04-07T21:16:01Z
Henry,2,1,1,29083,2020-04-07T21:16:01Z
Hickory,0,0,0,29085,2020-04-07T21:16:01Z
Holt,0,0,0,29087,2020-04-07T21:16:01Z
Howard,1,0,1,29089,2020-04-07T21:16:01Z
Howell,4,0,4,29091,2020-04-07T21:16:01Z
Iron,0,0,0,29093,2020-04-07T21:16:01Z
Jackson,154,10,144,29095,2020-04-07T21:16:01Z
Jasper,9,2,7,29097,2020-04-07T21:16:01Z
Jefferson,92,10,82,29099,2020-04-07T21:16:01Z
Johnson,33,1,32,29101,2020-04-07T21:16:01Z
Joplin,3,1,2,NA,2020-04-07T21:16:01Z
Kansas City,219,2,217,NA,2020-04-07T21:16:01Z
Knox,0,0,0,29103,2020-04-07T21:16:01Z
Laclede,0,0,0,29105,2020-04-07T21:16:01Z
Lafayette,28,0,28,29107,2020-04-07T21:16:01Z
Lawrence,0,0,0,29109,2020-04-07T21:16:01Z
Lewis,0,0,0,29111,2020-04-07T21:16:01Z
Lincoln,21,2,19,29113,2020-04-07T21:16:01Z
Linn,3,0,3,29115,2020-04-07T21:16:01Z
Livingston,1,0,1,29117,2020-04-07T21:16:01Z
Macon,2,0,2,29121,2020-04-07T21:16:01Z
Madison,1,0,1,29123,2020-04-07T21:16:01Z
Maries,2,0,2,29125,2020-04-07T21:16:01Z
Marion,0,0,0,29127,2020-04-07T21:16:01Z
McDonald,3,0,3,NA,2020-04-07T21:16:01Z
Mercer,0,0,0,29129,2020-04-07T21:16:01Z
Miller,0,0,0,29131,2020-04-07T21:16:01Z
Mississippi,0,0,0,29133,2020-04-07T21:16:01Z
Moniteau,4,0,4,29135,2020-04-07T21:16:01Z
Monroe,0,0,0,29137,2020-04-07T21:16:01Z
Montgomery,5,0,5,29139,2020-04-07T21:16:01Z
Morgan,1,0,1,29141,2020-04-07T21:16:01Z
New Madrid,5,0,5,29143,2020-04-07T21:16:01Z
Newton,6,3,3,29145,2020-04-07T21:16:01Z
Nodaway,2,0,2,29147,2020-04-07T21:16:01Z
Oregon,1,0,1,29149,2020-04-07T21:16:01Z
Osage,4,0,4,29151,2020-04-07T21:16:01Z
Ozark,0,0,0,29153,2020-04-07T21:16:01Z
Pemiscot,3,0,3,29155,2020-04-07T21:16:01Z
Perry,28,15,13,29157,2020-04-07T21:16:01Z
Pettis,3,0,3,29159,2020-04-07T21:16:01Z
Phelps,1,0,1,29161,2020-04-07T21:16:01Z
Pike,2,1,1,29163,2020-04-07T21:16:01Z
Platte,17,0,17,29165,2020-04-07T21:16:01Z
Polk,1,0,1,29167,2020-04-07T21:16:01Z
Pulaski,12,1,11,29169,2020-04-07T21:16:01Z
Putnam,0,0,0,29171,2020-04-07T21:16:01Z
Ralls,1,1,0,29173,2020-04-07T21:16:01Z
Randolph,7,0,7,29175,2020-04-07T21:16:01Z
Ray,7,1,6,29177,2020-04-07T21:16:01Z
Reynolds,2,1,1,29179,2020-04-07T21:16:01Z
Ripley,2,0,2,29181,2020-04-07T21:16:01Z
Saline,5,0,5,29195,2020-04-07T21:16:01Z
Schuyler,0,0,0,29197,2020-04-07T21:16:01Z
Scotland,1,0,1,29199,2020-04-07T21:16:01Z
Scott,10,2,8,29201,2020-04-07T21:16:01Z
Shannon,0,0,0,29203,2020-04-07T21:16:01Z
Shelby,1,1,0,29205,2020-04-07T21:16:01Z
St. Charles,221,22,199,29183,2020-04-07T21:16:01Z
St. Clair,0,0,0,29185,2020-04-07T21:16:01Z
St. Francois,19,4,15,29187,2020-04-07T21:16:01Z
St. Louis City,399,19,380,29510,2020-04-07T21:16:01Z
St. Louis,1203,56,1147,29189,2020-04-07T21:16:01Z
Ste. Genevieve,6,1,5,29186,2020-04-07T21:16:01Z
Stoddard,8,2,6,29207,2020-04-07T21:16:01Z
Stone,3,1,2,29209,2020-04-07T21:16:01Z
Sullivan,0,0,0,29211,2020-04-07T21:16:01Z
Taney,7,1,6,29213,2020-04-07T21:16:01Z
Texas,0,0,0,29215,2020-04-07T21:16:01Z
Vernon,0,0,0,29217,2020-04-07T21:16:01Z
Warren,11,0,11,29219,2020-04-07T21:16:01Z
Washington,0,0,0,29221,2020-04-07T21:16:01Z
Wayne,0,0,0,29223,2020-04-07T21:16:01Z
Webster,3,0,3,29225,2020-04-07T21:16:01Z
Worth,1,0,1,29227,2020-04-07T21:16:01Z
Wright,7,1,6,29229,2020-04-07T21:16:01Z
TBD,1,0,1,NA,2020-04-07T21:16:01Z
Adair,8,0,8,29001,2020-04-04T17:16:01Z
Andrew,0,0,0,29003,2020-04-04T17:16:01Z
Atchison,1,1,0,29005,2020-04-04T17:16:01Z
Audrain,0,0,0,29007,2020-04-04T17:16:01Z
Barry,1,0,1,29009,2020-04-04T17:16:01Z
Barton,0,0,0,29011,2020-04-04T17:16:01Z
Bates,3,0,3,29013,2020-04-04T17:16:01Z
Benton,3,0,3,29015,2020-04-04T17:16:01Z
Bollinger,1,0,1,29017,2020-04-04T17:16:01Z
Boone,74,3,71,29019,2020-04-04T17:16:01Z
Buchanan,8,4,4,29021,2020-04-04T17:16:01Z
Butler,1,0,1,29023,2020-04-04T17:16:01Z
Caldwell,1,0,1,29025,2020-04-04T17:16:01Z
Callaway,18,1,17,29027,2020-04-04T17:16:01Z
Camden,21,2,19,29029,2020-04-04T17:16:01Z
Cape Girardeau,15,0,15,29031,2020-04-04T17:16:01Z
Carroll,0,0,0,29033,2020-04-04T17:16:01Z
Carter,3,1,2,29035,2020-04-04T17:16:01Z
Cass,21,3,18,29037,2020-04-04T17:16:01Z
Cedar,4,0,4,29039,2020-04-04T17:16:01Z
Chariton,4,0,4,29041,2020-04-04T17:16:01Z
Christian,13,4,9,29043,2020-04-04T17:16:01Z
Clark,1,1,0,29045,2020-04-04T17:16:01Z
Clay,26,0,26,29047,2020-04-04T17:16:01Z
Clinton,8,0,8,29049,2020-04-04T17:16:01Z
Cole,26,3,23,29051,2020-04-04T17:16:01Z
Cooper,2,0,2,29053,2020-04-04T17:16:01Z
Crawford,1,0,1,29055,2020-04-04T17:16:01Z
Dade,0,0,0,29057,2020-04-04T17:16:01Z
Dallas,0,0,0,29059,2020-04-04T17:16:01Z
Daviess,0,0,0,29061,2020-04-04T17:16:01Z
DeKalb,1,0,1,NA,2020-04-04T17:16:01Z
Dent,0,0,0,29065,2020-04-04T17:16:01Z
Douglas,0,0,0,29067,2020-04-04T17:16:01Z
Dunklin,7,0,7,29069,2020-04-04T17:16:01Z
Franklin,23,0,23,29071,2020-04-04T17:16:01Z
Gasconade,1,0,1,29073,2020-04-04T17:16:01Z
Gentry,0,0,0,29075,2020-04-04T17:16:01Z
Greene,60,20,40,29077,2020-04-04T17:16:01Z
Grundy,0,0,0,29079,2020-04-04T17:16:01Z
Harrison,2,0,2,29081,2020-04-04T17:16:01Z
Henry,1,1,0,29083,2020-04-04T17:16:01Z
Hickory,0,0,0,29085,2020-04-04T17:16:01Z
Holt,0,0,0,29087,2020-04-04T17:16:01Z
Howard,0,0,0,29089,2020-04-04T17:16:01Z
Howell,1,0,1,29091,2020-04-04T17:16:01Z
Iron,0,0,0,29093,2020-04-04T17:16:01Z
Jackson,120,8,112,29095,2020-04-04T17:16:01Z
Jasper,8,1,7,29097,2020-04-04T17:16:01Z
Jefferson,62,8,54,29099,2020-04-04T17:16:01Z
Johnson,28,1,27,29101,2020-04-04T17:16:01Z
Joplin,1,0,1,NA,2020-04-04T17:16:01Z
Kansas City,153,2,151,NA,2020-04-04T17:16:01Z
Knox,0,0,0,29103,2020-04-04T17:16:01Z
Laclede,0,0,0,29105,2020-04-04T17:16:01Z
Lafayette,20,0,20,29107,2020-04-04T17:16:01Z
Lawrence,0,0,0,29109,2020-04-04T17:16:01Z
Lewis,0,0,0,29111,2020-04-04T17:16:01Z
Lincoln,16,2,14,29113,2020-04-04T17:16:01Z
Linn,0,0,0,29115,2020-04-04T17:16:01Z
Livingston,1,0,1,29117,2020-04-04T17:16:01Z
Macon,2,0,2,29121,2020-04-04T17:16:01Z
Madison,0,0,0,29123,2020-04-04T17:16:01Z
Maries,2,0,2,29125,2020-04-04T17:16:01Z
Marion,0,0,0,29127,2020-04-04T17:16:01Z
McDonald,2,0,2,NA,2020-04-04T17:16:01Z
Mercer,0,0,0,29129,2020-04-04T17:16:01Z
Miller,0,0,0,29131,2020-04-04T17:16:01Z
Mississippi,0,0,0,29133,2020-04-04T17:16:01Z
Moniteau,2,0,2,29135,2020-04-04T17:16:01Z
Monroe,0,0,0,29137,2020-04-04T17:16:01Z
Montgomery,3,0,3,29139,2020-04-04T17:16:01Z
Morgan,1,0,1,29141,2020-04-04T17:16:01Z
New Madrid,1,0,1,29143,2020-04-04T17:16:01Z
Newton,6,3,3,29145,2020-04-04T17:16:01Z
Nodaway,0,0,0,29147,2020-04-04T17:16:01Z
Oregon,0,0,0,29149,2020-04-04T17:16:01Z
Osage,2,0,2,29151,2020-04-04T17:16:01Z
Ozark,0,0,0,29153,2020-04-04T17:16:01Z
Pemiscot,3,0,3,29155,2020-04-04T17:16:01Z
Perry,21,11,10,29157,2020-04-04T17:16:01Z
Pettis,2,0,2,29159,2020-04-04T17:16:01Z
Phelps,0,0,0,29161,2020-04-04T17:16:01Z
Pike,2,1,1,29163,2020-04-04T17:16:01Z
Platte,12,0,12,29165,2020-04-04T17:16:01Z
Polk,0,0,0,29167,2020-04-04T17:16:01Z
Pulaski,10,1,9,29169,2020-04-04T17:16:01Z
Putnam,0,0,0,29171,2020-04-04T17:16:01Z
Ralls,1,1,0,29173,2020-04-04T17:16:01Z
Randolph,4,0,4,29175,2020-04-04T17:16:01Z
Ray,2,1,1,29177,2020-04-04T17:16:01Z
Reynolds,2,1,1,29179,2020-04-04T17:16:01Z
Ripley,2,0,2,29181,2020-04-04T17:16:01Z
Saline,2,0,2,29195,2020-04-04T17:16:01Z
Schuyler,0,0,0,29197,2020-04-04T17:16:01Z
Scotland,0,0,0,29199,2020-04-04T17:16:01Z
Scott,7,2,5,29201,2020-04-04T17:16:01Z
Shannon,0,0,0,29203,2020-04-04T17:16:01Z
Shelby,1,1,0,29205,2020-04-04T17:16:01Z
St. Charles,132,14,118,29183,2020-04-04T17:16:01Z
St. Clair,0,0,0,29185,2020-04-04T17:16:01Z
St. Francois,12,1,11,29187,2020-04-04T17:16:01Z
St. Louis City,275,13,262,29510,2020-04-04T17:16:01Z
St. Louis,794,39,755,29189,2020-04-04T17:16:01Z
Ste. Genevieve,6,1,5,29186,2020-04-04T17:16:01Z
Stoddard,7,2,5,29207,2020-04-04T17:16:01Z
Stone,2,1,1,29209,2020-04-04T17:16:01Z
Sullivan,0,0,0,29211,2020-04-04T17:16:01Z
Taney,5,0,5,29213,2020-04-04T17:16:01Z
Texas,0,0,0,29215,2020-04-04T17:16:01Z
Vernon,0,0,0,29217,2020-04-04T17:16:01Z
Warren,7,0,7,29219,2020-04-04T17:16:01Z
Washington,0,0,0,29221,2020-04-04T17:16:01Z
Wayne,0,0,0,29223,2020-04-04T17:16:01Z
Webster,2,0,2,29225,2020-04-04T17:16:01Z
Worth,0,0,0,29227,2020-04-04T17:16:01Z
Wright,6,1,5,29229,2020-04-04T17:16:01Z
TBD,3,0,3,NA,2020-04-04T17:16:01Z
Adair,8,0,8,29001,2020-04-04T13:16:01Z
Andrew,0,0,0,29003,2020-04-04T13:16:01Z
Atchison,1,1,0,29005,2020-04-04T13:16:01Z
Audrain,0,0,0,29007,2020-04-04T13:16:01Z
Barry,1,0,1,29009,2020-04-04T13:16:01Z
Barton,0,0,0,29011,2020-04-04T13:16:01Z
Bates,3,0,3,29013,2020-04-04T13:16:01Z
Benton,3,0,3,29015,2020-04-04T13:16:01Z
Bollinger,1,0,1,29017,2020-04-04T13:16:01Z
Boone,74,3,71,29019,2020-04-04T13:16:01Z
Buchanan,8,4,4,29021,2020-04-04T13:16:01Z
Butler,1,0,1,29023,2020-04-04T13:16:01Z
Caldwell,1,0,1,29025,2020-04-04T13:16:01Z
Callaway,18,1,17,29027,2020-04-04T13:16:01Z
Camden,21,2,19,29029,2020-04-04T13:16:01Z
Cape Girardeau,15,0,15,29031,2020-04-04T13:16:01Z
Carroll,0,0,0,29033,2020-04-04T13:16:01Z
Carter,3,1,2,29035,2020-04-04T13:16:01Z
Cass,21,3,18,29037,2020-04-04T13:16:01Z
Cedar,4,0,4,29039,2020-04-04T13:16:01Z
Chariton,4,0,4,29041,2020-04-04T13:16:01Z
Christian,13,4,9,29043,2020-04-04T13:16:01Z
Clark,1,1,0,29045,2020-04-04T13:16:01Z
Clay,26,0,26,29047,2020-04-04T13:16:01Z
Clinton,8,0,8,29049,2020-04-04T13:16:01Z
Cole,26,3,23,29051,2020-04-04T13:16:01Z
Cooper,2,0,2,29053,2020-04-04T13:16:01Z
Crawford,1,0,1,29055,2020-04-04T13:16:01Z
Dade,0,0,0,29057,2020-04-04T13:16:01Z
Dallas,0,0,0,29059,2020-04-04T13:16:01Z
Daviess,0,0,0,29061,2020-04-04T13:16:01Z
DeKalb,1,0,1,NA,2020-04-04T13:16:01Z
Dent,0,0,0,29065,2020-04-04T13:16:01Z
Douglas,0,0,0,29067,2020-04-04T13:16:01Z
Dunklin,7,0,7,29069,2020-04-04T13:16:01Z
Franklin,23,0,23,29071,2020-04-04T13:16:01Z
Gasconade,1,0,1,29073,2020-04-04T13:16:01Z
Gentry,0,0,0,29075,2020-04-04T13:16:01Z
Greene,60,20,40,29077,2020-04-04T13:16:01Z
Grundy,0,0,0,29079,2020-04-04T13:16:01Z
Harrison,2,0,2,29081,2020-04-04T13:16:01Z
Henry,1,1,0,29083,2020-04-04T13:16:01Z
Hickory,0,0,0,29085,2020-04-04T13:16:01Z
Holt,0,0,0,29087,2020-04-04T13:16:01Z
Howard,0,0,0,29089,2020-04-04T13:16:01Z
Howell,1,0,1,29091,2020-04-04T13:16:01Z
Iron,0,0,0,29093,2020-04-04T13:16:01Z
Jackson,120,8,112,29095,2020-04-04T13:16:01Z
Jasper,8,1,7,29097,2020-04-04T13:16:01Z
Jefferson,62,8,54,29099,2020-04-04T13:16:01Z
Johnson,28,1,27,29101,2020-04-04T13:16:01Z
Joplin,1,0,1,NA,2020-04-04T13:16:01Z
Kansas City,153,2,151,NA,2020-04-04T13:16:01Z
Knox,0,0,0,29103,2020-04-04T13:16:01Z
Laclede,0,0,0,29105,2020-04-04T13:16:01Z
Lafayette,20,0,20,29107,2020-04-04T13:16:01Z
Lawrence,0,0,0,29109,2020-04-04T13:16:01Z
Lewis,0,0,0,29111,2020-04-04T13:16:01Z
Lincoln,16,2,14,29113,2020-04-04T13:16:01Z
Linn,0,0,0,29115,2020-04-04T13:16:01Z
Livingston,1,0,1,29117,2020-04-04T13:16:01Z
Macon,2,0,2,29121,2020-04-04T13:16:01Z
Madison,0,0,0,29123,2020-04-04T13:16:01Z
Maries,2,0,2,29125,2020-04-04T13:16:01Z
Marion,0,0,0,29127,2020-04-04T13:16:01Z
McDonald,2,0,2,NA,2020-04-04T13:16:01Z
Mercer,0,0,0,29129,2020-04-04T13:16:01Z
Miller,0,0,0,29131,2020-04-04T13:16:01Z
Mississippi,0,0,0,29133,2020-04-04T13:16:01Z
Moniteau,2,0,2,29135,2020-04-04T13:16:01Z
Monroe,0,0,0,29137,2020-04-04T13:16:01Z
Montgomery,3,0,3,29139,2020-04-04T13:16:01Z
Morgan,1,0,1,29141,2020-04-04T13:16:01Z
New Madrid,1,0,1,29143,2020-04-04T13:16:01Z
Newton,6,3,3,29145,2020-04-04T13:16:01Z
Nodaway,0,0,0,29147,2020-04-04T13:16:01Z
Oregon,0,0,0,29149,2020-04-04T13:16:01Z
Osage,2,0,2,29151,2020-04-04T13:16:01Z
Ozark,0,0,0,29153,2020-04-04T13:16:01Z
Pemiscot,3,0,3,29155,2020-04-04T13:16:01Z
Perry,21,11,10,29157,2020-04-04T13:16:01Z
Pettis,2,0,2,29159,2020-04-04T13:16:01Z
Phelps,0,0,0,29161,2020-04-04T13:16:01Z
Pike,2,1,1,29163,2020-04-04T13:16:01Z
Platte,12,0,12,29165,2020-04-04T13:16:01Z
Polk,0,0,0,29167,2020-04-04T13:16:01Z
Pulaski,10,1,9,29169,2020-04-04T13:16:01Z
Putnam,0,0,0,29171,2020-04-04T13:16:01Z
Ralls,1,1,0,29173,2020-04-04T13:16:01Z
Randolph,4,0,4,29175,2020-04-04T13:16:01Z
Ray,2,1,1,29177,2020-04-04T13:16:01Z
Reynolds,2,1,1,29179,2020-04-04T13:16:01Z
Ripley,2,0,2,29181,2020-04-04T13:16:01Z
Saline,2,0,2,29195,2020-04-04T13:16:01Z
Schuyler,0,0,0,29197,2020-04-04T13:16:01Z
Scotland,0,0,0,29199,2020-04-04T13:16:01Z
Scott,7,2,5,29201,2020-04-04T13:16:01Z
Shannon,0,0,0,29203,2020-04-04T13:16:01Z
Shelby,1,1,0,29205,2020-04-04T13:16:01Z
St. Charles,132,14,118,29183,2020-04-04T13:16:01Z
St. Clair,0,0,0,29185,2020-04-04T13:16:01Z
St. Francois,12,1,11,29187,2020-04-04T13:16:01Z
St. Louis City,275,13,262,29510,2020-04-04T13:16:01Z
St. Louis,794,39,755,29189,2020-04-04T13:16:01Z
Ste. Genevieve,6,1,5,29186,2020-04-04T13:16:01Z
Stoddard,7,2,5,29207,2020-04-04T13:16:01Z
Stone,2,1,1,29209,2020-04-04T13:16:01Z
Sullivan,0,0,0,29211,2020-04-04T13:16:01Z
Taney,5,0,5,29213,2020-04-04T13:16:01Z
Texas,0,0,0,29215,2020-04-04T13:16:01Z
Vernon,0,0,0,29217,2020-04-04T13:16:01Z
Warren,7,0,7,29219,2020-04-04T13:16:01Z
Washington,0,0,0,29221,2020-04-04T13:16:01Z
Wayne,0,0,0,29223,2020-04-04T13:16:01Z
Webster,2,0,2,29225,2020-04-04T13:16:01Z
Worth,0,0,0,29227,2020-04-04T13:16:01Z
Wright,6,1,5,29229,2020-04-04T13:16:01Z
TBD,3,0,3,NA,2020-04-04T13:16:01Z
Adair,8,0,8,29001,2020-04-04T01:16:01Z
Andrew,0,0,0,29003,2020-04-04T01:16:01Z
Atchison,1,1,0,29005,2020-04-04T01:16:01Z
Audrain,0,0,0,29007,2020-04-04T01:16:01Z
Barry,1,0,1,29009,2020-04-04T01:16:01Z
Barton,0,0,0,29011,2020-04-04T01:16:01Z
Bates,3,0,3,29013,2020-04-04T01:16:01Z
Benton,3,0,3,29015,2020-04-04T01:16:01Z
Bollinger,1,0,1,29017,2020-04-04T01:16:01Z
Boone,74,3,71,29019,2020-04-04T01:16:01Z
Buchanan,8,4,4,29021,2020-04-04T01:16:01Z
Butler,1,0,1,29023,2020-04-04T01:16:01Z
Caldwell,1,0,1,29025,2020-04-04T01:16:01Z
Callaway,18,1,17,29027,2020-04-04T01:16:01Z
Camden,21,2,19,29029,2020-04-04T01:16:01Z
Cape Girardeau,15,0,15,29031,2020-04-04T01:16:01Z
Carroll,0,0,0,29033,2020-04-04T01:16:01Z
Carter,3,1,2,29035,2020-04-04T01:16:01Z
Cass,21,3,18,29037,2020-04-04T01:16:01Z
Cedar,4,0,4,29039,2020-04-04T01:16:01Z
Chariton,4,0,4,29041,2020-04-04T01:16:01Z
Christian,13,4,9,29043,2020-04-04T01:16:01Z
Clark,1,1,0,29045,2020-04-04T01:16:01Z
Clay,26,0,26,29047,2020-04-04T01:16:01Z
Clinton,8,0,8,29049,2020-04-04T01:16:01Z
Cole,26,3,23,29051,2020-04-04T01:16:01Z
Cooper,2,0,2,29053,2020-04-04T01:16:01Z
Crawford,1,0,1,29055,2020-04-04T01:16:01Z
Dade,0,0,0,29057,2020-04-04T01:16:01Z
Dallas,0,0,0,29059,2020-04-04T01:16:01Z
Daviess,0,0,0,29061,2020-04-04T01:16:01Z
DeKalb,1,0,1,NA,2020-04-04T01:16:01Z
Dent,0,0,0,29065,2020-04-04T01:16:01Z
Douglas,0,0,0,29067,2020-04-04T01:16:01Z
Dunklin,7,0,7,29069,2020-04-04T01:16:01Z
Franklin,23,0,23,29071,2020-04-04T01:16:01Z
Gasconade,1,0,1,29073,2020-04-04T01:16:01Z
Gentry,0,0,0,29075,2020-04-04T01:16:01Z
Greene,60,20,40,29077,2020-04-04T01:16:01Z
Grundy,0,0,0,29079,2020-04-04T01:16:01Z
Harrison,2,0,2,29081,2020-04-04T01:16:01Z
Henry,1,1,0,29083,2020-04-04T01:16:01Z
Hickory,0,0,0,29085,2020-04-04T01:16:01Z
Holt,0,0,0,29087,2020-04-04T01:16:01Z
Howard,0,0,0,29089,2020-04-04T01:16:01Z
Howell,1,0,1,29091,2020-04-04T01:16:01Z
Iron,0,0,0,29093,2020-04-04T01:16:01Z
Jackson,120,8,112,29095,2020-04-04T01:16:01Z
Jasper,8,1,7,29097,2020-04-04T01:16:01Z
Jefferson,62,8,54,29099,2020-04-04T01:16:01Z
Johnson,28,1,27,29101,2020-04-04T01:16:01Z
Joplin,1,0,1,NA,2020-04-04T01:16:01Z
Kansas City,153,2,151,NA,2020-04-04T01:16:01Z
Knox,0,0,0,29103,2020-04-04T01:16:01Z
Laclede,0,0,0,29105,2020-04-04T01:16:01Z
Lafayette,20,0,20,29107,2020-04-04T01:16:01Z
Lawrence,0,0,0,29109,2020-04-04T01:16:01Z
Lewis,0,0,0,29111,2020-04-04T01:16:01Z
Lincoln,16,2,14,29113,2020-04-04T01:16:01Z
Linn,0,0,0,29115,2020-04-04T01:16:01Z
Livingston,1,0,1,29117,2020-04-04T01:16:01Z
Macon,2,0,2,29121,2020-04-04T01:16:01Z
Madison,0,0,0,29123,2020-04-04T01:16:01Z
Maries,2,0,2,29125,2020-04-04T01:16:01Z
Marion,0,0,0,29127,2020-04-04T01:16:01Z
McDonald,2,0,2,NA,2020-04-04T01:16:01Z
Mercer,0,0,0,29129,2020-04-04T01:16:01Z
Miller,0,0,0,29131,2020-04-04T01:16:01Z
Mississippi,0,0,0,29133,2020-04-04T01:16:01Z
Moniteau,2,0,2,29135,2020-04-04T01:16:01Z
Monroe,0,0,0,29137,2020-04-04T01:16:01Z
Montgomery,3,0,3,29139,2020-04-04T01:16:01Z
Morgan,1,0,1,29141,2020-04-04T01:16:01Z
New Madrid,1,0,1,29143,2020-04-04T01:16:01Z
Newton,6,3,3,29145,2020-04-04T01:16:01Z
Nodaway,0,0,0,29147,2020-04-04T01:16:01Z
Oregon,0,0,0,29149,2020-04-04T01:16:01Z
Osage,2,0,2,29151,2020-04-04T01:16:01Z
Ozark,0,0,0,29153,2020-04-04T01:16:01Z
Pemiscot,3,0,3,29155,2020-04-04T01:16:01Z
Perry,21,11,10,29157,2020-04-04T01:16:01Z
Pettis,2,0,2,29159,2020-04-04T01:16:01Z
Phelps,0,0,0,29161,2020-04-04T01:16:01Z
Pike,2,1,1,29163,2020-04-04T01:16:01Z
Platte,12,0,12,29165,2020-04-04T01:16:01Z
Polk,0,0,0,29167,2020-04-04T01:16:01Z
Pulaski,10,1,9,29169,2020-04-04T01:16:01Z
Putnam,0,0,0,29171,2020-04-04T01:16:01Z
Ralls,1,1,0,29173,2020-04-04T01:16:01Z
Randolph,4,0,4,29175,2020-04-04T01:16:01Z
Ray,2,1,1,29177,2020-04-04T01:16:01Z
Reynolds,2,1,1,29179,2020-04-04T01:16:01Z
Ripley,2,0,2,29181,2020-04-04T01:16:01Z
Saline,2,0,2,29195,2020-04-04T01:16:01Z
Schuyler,0,0,0,29197,2020-04-04T01:16:01Z
Scotland,0,0,0,29199,2020-04-04T01:16:01Z
Scott,7,2,5,29201,2020-04-04T01:16:01Z
Shannon,0,0,0,29203,2020-04-04T01:16:01Z
Shelby,1,1,0,29205,2020-04-04T01:16:01Z
St. Charles,132,14,118,29183,2020-04-04T01:16:01Z
St. Clair,0,0,0,29185,2020-04-04T01:16:01Z
St. Francois,12,1,11,29187,2020-04-04T01:16:01Z
St. Louis City,275,13,262,29510,2020-04-04T01:16:01Z
St. Louis,794,39,755,29189,2020-04-04T01:16:01Z
Ste. Genevieve,6,1,5,29186,2020-04-04T01:16:01Z
Stoddard,7,2,5,29207,2020-04-04T01:16:01Z
Stone,2,1,1,29209,2020-04-04T01:16:01Z
Sullivan,0,0,0,29211,2020-04-04T01:16:01Z
Taney,5,0,5,29213,2020-04-04T01:16:01Z
Texas,0,0,0,29215,2020-04-04T01:16:01Z
Vernon,0,0,0,29217,2020-04-04T01:16:01Z
Warren,7,0,7,29219,2020-04-04T01:16:01Z
Washington,0,0,0,29221,2020-04-04T01:16:01Z
Wayne,0,0,0,29223,2020-04-04T01:16:01Z
Webster,2,0,2,29225,2020-04-04T01:16:01Z
Worth,0,0,0,29227,2020-04-04T01:16:01Z
Wright,6,1,5,29229,2020-04-04T01:16:01Z
TBD,3,0,3,NA,2020-04-04T01:16:01Z
Adair,8,0,8,29001,2020-04-03T21:16:01Z
Andrew,0,0,0,29003,2020-04-03T21:16:01Z
Atchison,1,1,0,29005,2020-04-03T21:16:01Z
Audrain,0,0,0,29007,2020-04-03T21:16:01Z
Barry,1,0,1,29009,2020-04-03T21:16:01Z
Barton,0,0,0,29011,2020-04-03T21:16:01Z
Bates,3,0,3,29013,2020-04-03T21:16:01Z
Benton,3,0,3,29015,2020-04-03T21:16:01Z
Bollinger,1,0,1,29017,2020-04-03T21:16:01Z
Boone,74,3,71,29019,2020-04-03T21:16:01Z
Buchanan,8,4,4,29021,2020-04-03T21:16:01Z
Butler,1,0,1,29023,2020-04-03T21:16:01Z
Caldwell,1,0,1,29025,2020-04-03T21:16:01Z
Callaway,18,1,17,29027,2020-04-03T21:16:01Z
Camden,21,2,19,29029,2020-04-03T21:16:01Z
Cape Girardeau,15,0,15,29031,2020-04-03T21:16:01Z
Carroll,0,0,0,29033,2020-04-03T21:16:01Z
Carter,3,1,2,29035,2020-04-03T21:16:01Z
Cass,21,3,18,29037,2020-04-03T21:16:01Z
Cedar,4,0,4,29039,2020-04-03T21:16:01Z
Chariton,4,0,4,29041,2020-04-03T21:16:01Z
Christian,13,4,9,29043,2020-04-03T21:16:01Z
Clark,1,1,0,29045,2020-04-03T21:16:01Z
Clay,26,0,26,29047,2020-04-03T21:16:01Z
Clinton,8,0,8,29049,2020-04-03T21:16:01Z
Cole,26,3,23,29051,2020-04-03T21:16:01Z
Cooper,2,0,2,29053,2020-04-03T21:16:01Z
Crawford,1,0,1,29055,2020-04-03T21:16:01Z
Dade,0,0,0,29057,2020-04-03T21:16:01Z
Dallas,0,0,0,29059,2020-04-03T21:16:01Z
Daviess,0,0,0,29061,2020-04-03T21:16:01Z
DeKalb,1,0,1,NA,2020-04-03T21:16:01Z
Dent,0,0,0,29065,2020-04-03T21:16:01Z
Douglas,0,0,0,29067,2020-04-03T21:16:01Z
Dunklin,7,0,7,29069,2020-04-03T21:16:01Z
Franklin,23,0,23,29071,2020-04-03T21:16:01Z
Gasconade,1,0,1,29073,2020-04-03T21:16:01Z
Gentry,0,0,0,29075,2020-04-03T21:16:01Z
Greene,60,20,40,29077,2020-04-03T21:16:01Z
Grundy,0,0,0,29079,2020-04-03T21:16:01Z
Harrison,2,0,2,29081,2020-04-03T21:16:01Z
Henry,1,1,0,29083,2020-04-03T21:16:01Z
Hickory,0,0,0,29085,2020-04-03T21:16:01Z
Holt,0,0,0,29087,2020-04-03T21:16:01Z
Howard,0,0,0,29089,2020-04-03T21:16:01Z
Howell,1,0,1,29091,2020-04-03T21:16:01Z
Iron,0,0,0,29093,2020-04-03T21:16:01Z
Jackson,120,8,112,29095,2020-04-03T21:16:01Z
Jasper,8,1,7,29097,2020-04-03T21:16:01Z
Jefferson,62,8,54,29099,2020-04-03T21:16:01Z
Johnson,28,1,27,29101,2020-04-03T21:16:01Z
Joplin,1,0,1,NA,2020-04-03T21:16:01Z
Kansas City,153,2,151,NA,2020-04-03T21:16:01Z
Knox,0,0,0,29103,2020-04-03T21:16:01Z
Laclede,0,0,0,29105,2020-04-03T21:16:01Z
Lafayette,20,0,20,29107,2020-04-03T21:16:01Z
Lawrence,0,0,0,29109,2020-04-03T21:16:01Z
Lewis,0,0,0,29111,2020-04-03T21:16:01Z
Lincoln,16,2,14,29113,2020-04-03T21:16:01Z
Linn,0,0,0,29115,2020-04-03T21:16:01Z
Livingston,1,0,1,29117,2020-04-03T21:16:01Z
Macon,2,0,2,29121,2020-04-03T21:16:01Z
Madison,0,0,0,29123,2020-04-03T21:16:01Z
Maries,2,0,2,29125,2020-04-03T21:16:01Z
Marion,0,0,0,29127,2020-04-03T21:16:01Z
McDonald,2,0,2,NA,2020-04-03T21:16:01Z
Mercer,0,0,0,29129,2020-04-03T21:16:01Z
Miller,0,0,0,29131,2020-04-03T21:16:01Z
Mississippi,0,0,0,29133,2020-04-03T21:16:01Z
Moniteau,2,0,2,29135,2020-04-03T21:16:01Z
Monroe,0,0,0,29137,2020-04-03T21:16:01Z
Montgomery,3,0,3,29139,2020-04-03T21:16:01Z
Morgan,1,0,1,29141,2020-04-03T21:16:01Z
New Madrid,1,0,1,29143,2020-04-03T21:16:01Z
Newton,6,3,3,29145,2020-04-03T21:16:01Z
Nodaway,0,0,0,29147,2020-04-03T21:16:01Z
Oregon,0,0,0,29149,2020-04-03T21:16:01Z
Osage,2,0,2,29151,2020-04-03T21:16:01Z
Ozark,0,0,0,29153,2020-04-03T21:16:01Z
Pemiscot,3,0,3,29155,2020-04-03T21:16:01Z
Perry,21,11,10,29157,2020-04-03T21:16:01Z
Pettis,2,0,2,29159,2020-04-03T21:16:01Z
Phelps,0,0,0,29161,2020-04-03T21:16:01Z
Pike,2,1,1,29163,2020-04-03T21:16:01Z
Platte,12,0,12,29165,2020-04-03T21:16:01Z
Polk,0,0,0,29167,2020-04-03T21:16:01Z
Pulaski,10,1,9,29169,2020-04-03T21:16:01Z
Putnam,0,0,0,29171,2020-04-03T21:16:01Z
Ralls,1,1,0,29173,2020-04-03T21:16:01Z
Randolph,4,0,4,29175,2020-04-03T21:16:01Z
Ray,2,1,1,29177,2020-04-03T21:16:01Z
Reynolds,2,1,1,29179,2020-04-03T21:16:01Z
Ripley,2,0,2,29181,2020-04-03T21:16:01Z
Saline,2,0,2,29195,2020-04-03T21:16:01Z
Schuyler,0,0,0,29197,2020-04-03T21:16:01Z
Scotland,0,0,0,29199,2020-04-03T21:16:01Z
Scott,7,2,5,29201,2020-04-03T21:16:01Z
Shannon,0,0,0,29203,2020-04-03T21:16:01Z
Shelby,1,1,0,29205,2020-04-03T21:16:01Z
St. Charles,132,14,118,29183,2020-04-03T21:16:01Z
St. Clair,0,0,0,29185,2020-04-03T21:16:01Z
St. Francois,12,1,11,29187,2020-04-03T21:16:01Z
St. Louis City,275,13,262,29510,2020-04-03T21:16:01Z
St. Louis,794,39,755,29189,2020-04-03T21:16:01Z
Ste. Genevieve,6,1,5,29186,2020-04-03T21:16:01Z
Stoddard,7,2,5,29207,2020-04-03T21:16:01Z
Stone,2,1,1,29209,2020-04-03T21:16:01Z
Sullivan,0,0,0,29211,2020-04-03T21:16:01Z
Taney,5,0,5,29213,2020-04-03T21:16:01Z
Texas,0,0,0,29215,2020-04-03T21:16:01Z
Vernon,0,0,0,29217,2020-04-03T21:16:01Z
Warren,7,0,7,29219,2020-04-03T21:16:01Z
Washington,0,0,0,29221,2020-04-03T21:16:01Z
Wayne,0,0,0,29223,2020-04-03T21:16:01Z
Webster,2,0,2,29225,2020-04-03T21:16:01Z
Worth,0,0,0,29227,2020-04-03T21:16:01Z
Wright,6,1,5,29229,2020-04-03T21:16:01Z
TBD,3,0,3,NA,2020-04-03T21:16:01Z
Adair,6,0,6,29001,2020-04-03T17:16:01Z
Andrew,0,0,0,29003,2020-04-03T17:16:01Z
Atchison,1,1,0,29005,2020-04-03T17:16:01Z
Audrain,0,0,0,29007,2020-04-03T17:16:01Z
Barry,1,0,1,29009,2020-04-03T17:16:01Z
Barton,0,0,0,29011,2020-04-03T17:16:01Z
Bates,2,0,2,29013,2020-04-03T17:16:01Z
Benton,3,0,3,29015,2020-04-03T17:16:01Z
Bollinger,1,0,1,29017,2020-04-03T17:16:01Z
Boone,69,2,67,29019,2020-04-03T17:16:01Z
Buchanan,5,1,4,29021,2020-04-03T17:16:01Z
Butler,1,0,1,29023,2020-04-03T17:16:01Z
Caldwell,1,0,1,29025,2020-04-03T17:16:01Z
Callaway,18,1,17,29027,2020-04-03T17:16:01Z
Camden,19,2,17,29029,2020-04-03T17:16:01Z
Cape Girardeau,15,0,15,29031,2020-04-03T17:16:01Z
Carroll,0,0,0,29033,2020-04-03T17:16:01Z
Carter,3,1,2,29035,2020-04-03T17:16:01Z
Cass,21,3,18,29037,2020-04-03T17:16:01Z
Cedar,3,0,3,29039,2020-04-03T17:16:01Z
Chariton,4,0,4,29041,2020-04-03T17:16:01Z
Christian,12,4,8,29043,2020-04-03T17:16:01Z
Clark,0,0,0,29045,2020-04-03T17:16:01Z
Clay,23,0,23,29047,2020-04-03T17:16:01Z
Clinton,6,0,6,29049,2020-04-03T17:16:01Z
Cole,25,3,22,29051,2020-04-03T17:16:01Z
Cooper,2,0,2,29053,2020-04-03T17:16:01Z
Crawford,1,0,1,29055,2020-04-03T17:16:01Z
Dade,0,0,0,29057,2020-04-03T17:16:01Z
Dallas,0,0,0,29059,2020-04-03T17:16:01Z
Daviess,0,0,0,29061,2020-04-03T17:16:01Z
DeKalb,1,0,1,NA,2020-04-03T17:16:01Z
Dent,0,0,0,29065,2020-04-03T17:16:01Z
Douglas,0,0,0,29067,2020-04-03T17:16:01Z
Dunklin,6,0,6,29069,2020-04-03T17:16:01Z
Franklin,19,0,19,29071,2020-04-03T17:16:01Z
Gasconade,1,0,1,29073,2020-04-03T17:16:01Z
Gentry,0,0,0,29075,2020-04-03T17:16:01Z
Greene,54,19,35,29077,2020-04-03T17:16:01Z
Grundy,0,0,0,29079,2020-04-03T17:16:01Z
Harrison,2,0,2,29081,2020-04-03T17:16:01Z
Henry,1,1,0,29083,2020-04-03T17:16:01Z
Hickory,0,0,0,29085,2020-04-03T17:16:01Z
Holt,0,0,0,29087,2020-04-03T17:16:01Z
Howard,0,0,0,29089,2020-04-03T17:16:01Z
Howell,1,0,1,29091,2020-04-03T17:16:01Z
Iron,0,0,0,29093,2020-04-03T17:16:01Z
Jackson,103,5,98,29095,2020-04-03T17:16:01Z
Jasper,5,1,4,29097,2020-04-03T17:16:01Z
Jefferson,47,5,42,29099,2020-04-03T17:16:01Z
Johnson,26,1,25,29101,2020-04-03T17:16:01Z
Joplin,1,0,1,NA,2020-04-03T17:16:01Z
Kansas City,139,2,137,NA,2020-04-03T17:16:01Z
Knox,0,0,0,29103,2020-04-03T17:16:01Z
Laclede,0,0,0,29105,2020-04-03T17:16:01Z
Lafayette,20,0,20,29107,2020-04-03T17:16:01Z
Lawrence,0,0,0,29109,2020-04-03T17:16:01Z
Lewis,0,0,0,29111,2020-04-03T17:16:01Z
Lincoln,12,2,10,29113,2020-04-03T17:16:01Z
Linn,0,0,0,29115,2020-04-03T17:16:01Z
Livingston,1,0,1,29117,2020-04-03T17:16:01Z
Macon,2,0,2,29121,2020-04-03T17:16:01Z
Madison,0,0,0,29123,2020-04-03T17:16:01Z
Maries,2,0,2,29125,2020-04-03T17:16:01Z
Marion,0,0,0,29127,2020-04-03T17:16:01Z
McDonald,2,0,2,NA,2020-04-03T17:16:01Z
Mercer,0,0,0,29129,2020-04-03T17:16:01Z
Miller,0,0,0,29131,2020-04-03T17:16:01Z
Mississippi,0,0,0,29133,2020-04-03T17:16:01Z
Moniteau,2,0,2,29135,2020-04-03T17:16:01Z
Monroe,0,0,0,29137,2020-04-03T17:16:01Z
Montgomery,2,0,2,29139,2020-04-03T17:16:01Z
Morgan,1,0,1,29141,2020-04-03T17:16:01Z
New Madrid,1,0,1,29143,2020-04-03T17:16:01Z
Newton,6,3,3,29145,2020-04-03T17:16:01Z
Nodaway,0,0,0,29147,2020-04-03T17:16:01Z
Oregon,0,0,0,29149,2020-04-03T17:16:01Z
Osage,2,0,2,29151,2020-04-03T17:16:01Z
Ozark,0,0,0,29153,2020-04-03T17:16:01Z
Pemiscot,3,0,3,29155,2020-04-03T17:16:01Z
Perry,19,11,8,29157,2020-04-03T17:16:01Z
Pettis,1,0,1,29159,2020-04-03T17:16:01Z
Phelps,0,0,0,29161,2020-04-03T17:16:01Z
Pike,1,1,0,29163,2020-04-03T17:16:01Z
Platte,13,0,13,29165,2020-04-03T17:16:01Z
Polk,0,0,0,29167,2020-04-03T17:16:01Z
Pulaski,8,1,7,29169,2020-04-03T17:16:01Z
Putnam,0,0,0,29171,2020-04-03T17:16:01Z
Ralls,1,1,0,29173,2020-04-03T17:16:01Z
Randolph,2,0,2,29175,2020-04-03T17:16:01Z
Ray,1,0,1,29177,2020-04-03T17:16:01Z
Reynolds,2,1,1,29179,2020-04-03T17:16:01Z
Ripley,2,0,2,29181,2020-04-03T17:16:01Z
Saline,0,0,0,29195,2020-04-03T17:16:01Z
Schuyler,0,0,0,29197,2020-04-03T17:16:01Z
Scotland,0,0,0,29199,2020-04-03T17:16:01Z
Scott,6,1,5,29201,2020-04-03T17:16:01Z
Shannon,0,0,0,29203,2020-04-03T17:16:01Z
Shelby,1,1,0,29205,2020-04-03T17:16:01Z
St. Charles,105,12,93,29183,2020-04-03T17:16:01Z
St. Clair,0,0,0,29185,2020-04-03T17:16:01Z
St. Francois,9,1,8,29187,2020-04-03T17:16:01Z
St. Louis City,216,13,203,29510,2020-04-03T17:16:01Z
St. Louis,712,35,677,29189,2020-04-03T17:16:01Z
Ste. Genevieve,3,1,2,29186,2020-04-03T17:16:01Z
Stoddard,6,1,5,29207,2020-04-03T17:16:01Z
Stone,2,1,1,29209,2020-04-03T17:16:01Z
Sullivan,0,0,0,29211,2020-04-03T17:16:01Z
Taney,2,0,2,29213,2020-04-03T17:16:01Z
Texas,0,0,0,29215,2020-04-03T17:16:01Z
Vernon,0,0,0,29217,2020-04-03T17:16:01Z
Warren,7,0,7,29219,2020-04-03T17:16:01Z
Washington,0,0,0,29221,2020-04-03T17:16:01Z
Wayne,0,0,0,29223,2020-04-03T17:16:01Z
Webster,2,0,2,29225,2020-04-03T17:16:01Z
Worth,0,0,0,29227,2020-04-03T17:16:01Z
Wright,6,1,5,29229,2020-04-03T17:16:01Z
TBD,3,1,2,NA,2020-04-03T17:16:01Z
Adair,6,0,6,29001,2020-04-03T13:16:01Z
Andrew,0,0,0,29003,2020-04-03T13:16:01Z
Atchison,1,1,0,29005,2020-04-03T13:16:01Z
Audrain,0,0,0,29007,2020-04-03T13:16:01Z
Barry,1,0,1,29009,2020-04-03T13:16:01Z
Barton,0,0,0,29011,2020-04-03T13:16:01Z
Bates,2,0,2,29013,2020-04-03T13:16:01Z
Benton,3,0,3,29015,2020-04-03T13:16:01Z
Bollinger,1,0,1,29017,2020-04-03T13:16:01Z
Boone,69,2,67,29019,2020-04-03T13:16:01Z
Buchanan,5,1,4,29021,2020-04-03T13:16:01Z
Butler,1,0,1,29023,2020-04-03T13:16:01Z
Caldwell,1,0,1,29025,2020-04-03T13:16:01Z
Callaway,18,1,17,29027,2020-04-03T13:16:01Z
Camden,19,2,17,29029,2020-04-03T13:16:01Z
Cape Girardeau,15,0,15,29031,2020-04-03T13:16:01Z
Carroll,0,0,0,29033,2020-04-03T13:16:01Z
Carter,3,1,2,29035,2020-04-03T13:16:01Z
Cass,21,3,18,29037,2020-04-03T13:16:01Z
Cedar,3,0,3,29039,2020-04-03T13:16:01Z
Chariton,4,0,4,29041,2020-04-03T13:16:01Z
Christian,12,4,8,29043,2020-04-03T13:16:01Z
Clark,0,0,0,29045,2020-04-03T13:16:01Z
Clay,23,0,23,29047,2020-04-03T13:16:01Z
Clinton,6,0,6,29049,2020-04-03T13:16:01Z
Cole,25,3,22,29051,2020-04-03T13:16:01Z
Cooper,2,0,2,29053,2020-04-03T13:16:01Z
Crawford,1,0,1,29055,2020-04-03T13:16:01Z
Dade,0,0,0,29057,2020-04-03T13:16:01Z
Dallas,0,0,0,29059,2020-04-03T13:16:01Z
Daviess,0,0,0,29061,2020-04-03T13:16:01Z
DeKalb,1,0,1,NA,2020-04-03T13:16:01Z
Dent,0,0,0,29065,2020-04-03T13:16:01Z
Douglas,0,0,0,29067,2020-04-03T13:16:01Z
Dunklin,6,0,6,29069,2020-04-03T13:16:01Z
Franklin,19,0,19,29071,2020-04-03T13:16:01Z
Gasconade,1,0,1,29073,2020-04-03T13:16:01Z
Gentry,0,0,0,29075,2020-04-03T13:16:01Z
Greene,54,19,35,29077,2020-04-03T13:16:01Z
Grundy,0,0,0,29079,2020-04-03T13:16:01Z
Harrison,2,0,2,29081,2020-04-03T13:16:01Z
Henry,1,1,0,29083,2020-04-03T13:16:01Z
Hickory,0,0,0,29085,2020-04-03T13:16:01Z
Holt,0,0,0,29087,2020-04-03T13:16:01Z
Howard,0,0,0,29089,2020-04-03T13:16:01Z
Howell,1,0,1,29091,2020-04-03T13:16:01Z
Iron,0,0,0,29093,2020-04-03T13:16:01Z
Jackson,103,5,98,29095,2020-04-03T13:16:01Z
Jasper,5,1,4,29097,2020-04-03T13:16:01Z
Jefferson,47,5,42,29099,2020-04-03T13:16:01Z
Johnson,26,1,25,29101,2020-04-03T13:16:01Z
Joplin,1,0,1,NA,2020-04-03T13:16:01Z
Kansas City,139,2,137,NA,2020-04-03T13:16:01Z
Knox,0,0,0,29103,2020-04-03T13:16:01Z
Laclede,0,0,0,29105,2020-04-03T13:16:01Z
Lafayette,20,0,20,29107,2020-04-03T13:16:01Z
Lawrence,0,0,0,29109,2020-04-03T13:16:01Z
Lewis,0,0,0,29111,2020-04-03T13:16:01Z
Lincoln,12,2,10,29113,2020-04-03T13:16:01Z
Linn,0,0,0,29115,2020-04-03T13:16:01Z
Livingston,1,0,1,29117,2020-04-03T13:16:01Z
Macon,2,0,2,29121,2020-04-03T13:16:01Z
Madison,0,0,0,29123,2020-04-03T13:16:01Z
Maries,2,0,2,29125,2020-04-03T13:16:01Z
Marion,0,0,0,29127,2020-04-03T13:16:01Z
McDonald,2,0,2,NA,2020-04-03T13:16:01Z
Mercer,0,0,0,29129,2020-04-03T13:16:01Z
Miller,0,0,0,29131,2020-04-03T13:16:01Z
Mississippi,0,0,0,29133,2020-04-03T13:16:01Z
Moniteau,2,0,2,29135,2020-04-03T13:16:01Z
Monroe,0,0,0,29137,2020-04-03T13:16:01Z
Montgomery,2,0,2,29139,2020-04-03T13:16:01Z
Morgan,1,0,1,29141,2020-04-03T13:16:01Z
New Madrid,1,0,1,29143,2020-04-03T13:16:01Z
Newton,6,3,3,29145,2020-04-03T13:16:01Z
Nodaway,0,0,0,29147,2020-04-03T13:16:01Z
Oregon,0,0,0,29149,2020-04-03T13:16:01Z
Osage,2,0,2,29151,2020-04-03T13:16:01Z
Ozark,0,0,0,29153,2020-04-03T13:16:01Z
Pemiscot,3,0,3,29155,2020-04-03T13:16:01Z
Perry,19,11,8,29157,2020-04-03T13:16:01Z
Pettis,1,0,1,29159,2020-04-03T13:16:01Z
Phelps,0,0,0,29161,2020-04-03T13:16:01Z
Pike,1,1,0,29163,2020-04-03T13:16:01Z
Platte,13,0,13,29165,2020-04-03T13:16:01Z
Polk,0,0,0,29167,2020-04-03T13:16:01Z
Pulaski,8,1,7,29169,2020-04-03T13:16:01Z
Putnam,0,0,0,29171,2020-04-03T13:16:01Z
Ralls,1,1,0,29173,2020-04-03T13:16:01Z
Randolph,2,0,2,29175,2020-04-03T13:16:01Z
Ray,1,0,1,29177,2020-04-03T13:16:01Z
Reynolds,2,1,1,29179,2020-04-03T13:16:01Z
Ripley,2,0,2,29181,2020-04-03T13:16:01Z
Saline,0,0,0,29195,2020-04-03T13:16:01Z
Schuyler,0,0,0,29197,2020-04-03T13:16:01Z
Scotland,0,0,0,29199,2020-04-03T13:16:01Z
Scott,6,1,5,29201,2020-04-03T13:16:01Z
Shannon,0,0,0,29203,2020-04-03T13:16:01Z
Shelby,1,1,0,29205,2020-04-03T13:16:01Z
St. Charles,105,12,93,29183,2020-04-03T13:16:01Z
St. Clair,0,0,0,29185,2020-04-03T13:16:01Z
St. Francois,9,1,8,29187,2020-04-03T13:16:01Z
St. Louis City,216,13,203,29510,2020-04-03T13:16:01Z
St. Louis,712,35,677,29189,2020-04-03T13:16:01Z
Ste. Genevieve,3,1,2,29186,2020-04-03T13:16:01Z
Stoddard,6,1,5,29207,2020-04-03T13:16:01Z
Stone,2,1,1,29209,2020-04-03T13:16:01Z
Sullivan,0,0,0,29211,2020-04-03T13:16:01Z
Taney,2,0,2,29213,2020-04-03T13:16:01Z
Texas,0,0,0,29215,2020-04-03T13:16:01Z
Vernon,0,0,0,29217,2020-04-03T13:16:01Z
Warren,7,0,7,29219,2020-04-03T13:16:01Z
Washington,0,0,0,29221,2020-04-03T13:16:01Z
Wayne,0,0,0,29223,2020-04-03T13:16:01Z
Webster,2,0,2,29225,2020-04-03T13:16:01Z
Worth,0,0,0,29227,2020-04-03T13:16:01Z
Wright,6,1,5,29229,2020-04-03T13:16:01Z
TBD,3,1,2,NA,2020-04-03T13:16:01Z
Adair,6,0,6,29001,2020-04-03T01:16:01Z
Andrew,0,0,0,29003,2020-04-03T01:16:01Z
Atchison,1,1,0,29005,2020-04-03T01:16:01Z
Audrain,0,0,0,29007,2020-04-03T01:16:01Z
Barry,1,0,1,29009,2020-04-03T01:16:01Z
Barton,0,0,0,29011,2020-04-03T01:16:01Z
Bates,2,0,2,29013,2020-04-03T01:16:01Z
Benton,3,0,3,29015,2020-04-03T01:16:01Z
Bollinger,1,0,1,29017,2020-04-03T01:16:01Z
Boone,69,2,67,29019,2020-04-03T01:16:01Z
Buchanan,5,1,4,29021,2020-04-03T01:16:01Z
Butler,1,0,1,29023,2020-04-03T01:16:01Z
Caldwell,1,0,1,29025,2020-04-03T01:16:01Z
Callaway,18,1,17,29027,2020-04-03T01:16:01Z
Camden,19,2,17,29029,2020-04-03T01:16:01Z
Cape Girardeau,15,0,15,29031,2020-04-03T01:16:01Z
Carroll,0,0,0,29033,2020-04-03T01:16:01Z
Carter,3,1,2,29035,2020-04-03T01:16:01Z
Cass,21,3,18,29037,2020-04-03T01:16:01Z
Cedar,3,0,3,29039,2020-04-03T01:16:01Z
Chariton,4,0,4,29041,2020-04-03T01:16:01Z
Christian,12,4,8,29043,2020-04-03T01:16:01Z
Clark,0,0,0,29045,2020-04-03T01:16:01Z
Clay,23,0,23,29047,2020-04-03T01:16:01Z
Clinton,6,0,6,29049,2020-04-03T01:16:01Z
Cole,25,3,22,29051,2020-04-03T01:16:01Z
Cooper,2,0,2,29053,2020-04-03T01:16:01Z
Crawford,1,0,1,29055,2020-04-03T01:16:01Z
Dade,0,0,0,29057,2020-04-03T01:16:01Z
Dallas,0,0,0,29059,2020-04-03T01:16:01Z
Daviess,0,0,0,29061,2020-04-03T01:16:01Z
DeKalb,1,0,1,NA,2020-04-03T01:16:01Z
Dent,0,0,0,29065,2020-04-03T01:16:01Z
Douglas,0,0,0,29067,2020-04-03T01:16:01Z
Dunklin,6,0,6,29069,2020-04-03T01:16:01Z
Franklin,19,0,19,29071,2020-04-03T01:16:01Z
Gasconade,1,0,1,29073,2020-04-03T01:16:01Z
Gentry,0,0,0,29075,2020-04-03T01:16:01Z
Greene,54,19,35,29077,2020-04-03T01:16:01Z
Grundy,0,0,0,29079,2020-04-03T01:16:01Z
Harrison,2,0,2,29081,2020-04-03T01:16:01Z
Henry,1,1,0,29083,2020-04-03T01:16:01Z
Hickory,0,0,0,29085,2020-04-03T01:16:01Z
Holt,0,0,0,29087,2020-04-03T01:16:01Z
Howard,0,0,0,29089,2020-04-03T01:16:01Z
Howell,1,0,1,29091,2020-04-03T01:16:01Z
Iron,0,0,0,29093,2020-04-03T01:16:01Z
Jackson,103,5,98,29095,2020-04-03T01:16:01Z
Jasper,5,1,4,29097,2020-04-03T01:16:01Z
Jefferson,47,5,42,29099,2020-04-03T01:16:01Z
Johnson,26,1,25,29101,2020-04-03T01:16:01Z
Joplin,1,0,1,NA,2020-04-03T01:16:01Z
Kansas City,139,2,137,NA,2020-04-03T01:16:01Z
Knox,0,0,0,29103,2020-04-03T01:16:01Z
Laclede,0,0,0,29105,2020-04-03T01:16:01Z
Lafayette,20,0,20,29107,2020-04-03T01:16:01Z
Lawrence,0,0,0,29109,2020-04-03T01:16:01Z
Lewis,0,0,0,29111,2020-04-03T01:16:01Z
Lincoln,12,2,10,29113,2020-04-03T01:16:01Z
Linn,0,0,0,29115,2020-04-03T01:16:01Z
Livingston,1,0,1,29117,2020-04-03T01:16:01Z
Macon,2,0,2,29121,2020-04-03T01:16:01Z
Madison,0,0,0,29123,2020-04-03T01:16:01Z
Maries,2,0,2,29125,2020-04-03T01:16:01Z
Marion,0,0,0,29127,2020-04-03T01:16:01Z
McDonald,2,0,2,NA,2020-04-03T01:16:01Z
Mercer,0,0,0,29129,2020-04-03T01:16:01Z
Miller,0,0,0,29131,2020-04-03T01:16:01Z
Mississippi,0,0,0,29133,2020-04-03T01:16:01Z
Moniteau,2,0,2,29135,2020-04-03T01:16:01Z
Monroe,0,0,0,29137,2020-04-03T01:16:01Z
Montgomery,2,0,2,29139,2020-04-03T01:16:01Z
Morgan,1,0,1,29141,2020-04-03T01:16:01Z
New Madrid,1,0,1,29143,2020-04-03T01:16:01Z
Newton,6,3,3,29145,2020-04-03T01:16:01Z
Nodaway,0,0,0,29147,2020-04-03T01:16:01Z
Oregon,0,0,0,29149,2020-04-03T01:16:01Z
Osage,2,0,2,29151,2020-04-03T01:16:01Z
Ozark,0,0,0,29153,2020-04-03T01:16:01Z
Pemiscot,3,0,3,29155,2020-04-03T01:16:01Z
Perry,19,11,8,29157,2020-04-03T01:16:01Z
Pettis,1,0,1,29159,2020-04-03T01:16:01Z
Phelps,0,0,0,29161,2020-04-03T01:16:01Z
Pike,1,1,0,29163,2020-04-03T01:16:01Z
Platte,13,0,13,29165,2020-04-03T01:16:01Z
Polk,0,0,0,29167,2020-04-03T01:16:01Z
Pulaski,8,1,7,29169,2020-04-03T01:16:01Z
Putnam,0,0,0,29171,2020-04-03T01:16:01Z
Ralls,1,1,0,29173,2020-04-03T01:16:01Z
Randolph,2,0,2,29175,2020-04-03T01:16:01Z
Ray,1,0,1,29177,2020-04-03T01:16:01Z
Reynolds,2,1,1,29179,2020-04-03T01:16:01Z
Ripley,2,0,2,29181,2020-04-03T01:16:01Z
Saline,0,0,0,29195,2020-04-03T01:16:01Z
Schuyler,0,0,0,29197,2020-04-03T01:16:01Z
Scotland,0,0,0,29199,2020-04-03T01:16:01Z
Scott,6,1,5,29201,2020-04-03T01:16:01Z
Shannon,0,0,0,29203,2020-04-03T01:16:01Z
Shelby,1,1,0,29205,2020-04-03T01:16:01Z
St. Charles,105,12,93,29183,2020-04-03T01:16:01Z
St. Clair,0,0,0,29185,2020-04-03T01:16:01Z
St. Francois,9,1,8,29187,2020-04-03T01:16:01Z
St. Louis City,216,13,203,29510,2020-04-03T01:16:01Z
St. Louis,712,35,677,29189,2020-04-03T01:16:01Z
Ste. Genevieve,3,1,2,29186,2020-04-03T01:16:01Z
Stoddard,6,1,5,29207,2020-04-03T01:16:01Z
Stone,2,1,1,29209,2020-04-03T01:16:01Z
Sullivan,0,0,0,29211,2020-04-03T01:16:01Z
Taney,2,0,2,29213,2020-04-03T01:16:01Z
Texas,0,0,0,29215,2020-04-03T01:16:01Z
Vernon,0,0,0,29217,2020-04-03T01:16:01Z
Warren,7,0,7,29219,2020-04-03T01:16:01Z
Washington,0,0,0,29221,2020-04-03T01:16:01Z
Wayne,0,0,0,29223,2020-04-03T01:16:01Z
Webster,2,0,2,29225,2020-04-03T01:16:01Z
Worth,0,0,0,29227,2020-04-03T01:16:01Z
Wright,6,1,5,29229,2020-04-03T01:16:01Z
TBD,3,1,2,NA,2020-04-03T01:16:01Z
Adair,6,0,6,29001,2020-04-02T21:16:01Z
Andrew,0,0,0,29003,2020-04-02T21:16:01Z
Atchison,1,1,0,29005,2020-04-02T21:16:01Z
Audrain,0,0,0,29007,2020-04-02T21:16:01Z
Barry,1,0,1,29009,2020-04-02T21:16:01Z
Barton,0,0,0,29011,2020-04-02T21:16:01Z
Bates,2,0,2,29013,2020-04-02T21:16:01Z
Benton,3,0,3,29015,2020-04-02T21:16:01Z
Bollinger,1,0,1,29017,2020-04-02T21:16:01Z
Boone,69,2,67,29019,2020-04-02T21:16:01Z
Buchanan,5,1,4,29021,2020-04-02T21:16:01Z
Butler,1,0,1,29023,2020-04-02T21:16:01Z
Caldwell,1,0,1,29025,2020-04-02T21:16:01Z
Callaway,18,1,17,29027,2020-04-02T21:16:01Z
Camden,19,2,17,29029,2020-04-02T21:16:01Z
Cape Girardeau,15,0,15,29031,2020-04-02T21:16:01Z
Carroll,0,0,0,29033,2020-04-02T21:16:01Z
Carter,3,1,2,29035,2020-04-02T21:16:01Z
Cass,21,3,18,29037,2020-04-02T21:16:01Z
Cedar,3,0,3,29039,2020-04-02T21:16:01Z
Chariton,4,0,4,29041,2020-04-02T21:16:01Z
Christian,12,4,8,29043,2020-04-02T21:16:01Z
Clark,0,0,0,29045,2020-04-02T21:16:01Z
Clay,23,0,23,29047,2020-04-02T21:16:01Z
Clinton,6,0,6,29049,2020-04-02T21:16:01Z
Cole,25,3,22,29051,2020-04-02T21:16:01Z
Cooper,2,0,2,29053,2020-04-02T21:16:01Z
Crawford,1,0,1,29055,2020-04-02T21:16:01Z
Dade,0,0,0,29057,2020-04-02T21:16:01Z
Dallas,0,0,0,29059,2020-04-02T21:16:01Z
Daviess,0,0,0,29061,2020-04-02T21:16:01Z
DeKalb,1,0,1,NA,2020-04-02T21:16:01Z
Dent,0,0,0,29065,2020-04-02T21:16:01Z
Douglas,0,0,0,29067,2020-04-02T21:16:01Z
Dunklin,6,0,6,29069,2020-04-02T21:16:01Z
Franklin,19,0,19,29071,2020-04-02T21:16:01Z
Gasconade,1,0,1,29073,2020-04-02T21:16:01Z
Gentry,0,0,0,29075,2020-04-02T21:16:01Z
Greene,54,19,35,29077,2020-04-02T21:16:01Z
Grundy,0,0,0,29079,2020-04-02T21:16:01Z
Harrison,2,0,2,29081,2020-04-02T21:16:01Z
Henry,1,1,0,29083,2020-04-02T21:16:01Z
Hickory,0,0,0,29085,2020-04-02T21:16:01Z
Holt,0,0,0,29087,2020-04-02T21:16:01Z
Howard,0,0,0,29089,2020-04-02T21:16:01Z
Howell,1,0,1,29091,2020-04-02T21:16:01Z
Iron,0,0,0,29093,2020-04-02T21:16:01Z
Jackson,103,5,98,29095,2020-04-02T21:16:01Z
Jasper,5,1,4,29097,2020-04-02T21:16:01Z
Jefferson,47,5,42,29099,2020-04-02T21:16:01Z
Johnson,26,1,25,29101,2020-04-02T21:16:01Z
Joplin,1,0,1,NA,2020-04-02T21:16:01Z
Kansas City,139,2,137,NA,2020-04-02T21:16:01Z
Knox,0,0,0,29103,2020-04-02T21:16:01Z
Laclede,0,0,0,29105,2020-04-02T21:16:01Z
Lafayette,20,0,20,29107,2020-04-02T21:16:01Z
Lawrence,0,0,0,29109,2020-04-02T21:16:01Z
Lewis,0,0,0,29111,2020-04-02T21:16:01Z
Lincoln,12,2,10,29113,2020-04-02T21:16:01Z
Linn,0,0,0,29115,2020-04-02T21:16:01Z
Livingston,1,0,1,29117,2020-04-02T21:16:01Z
Macon,2,0,2,29121,2020-04-02T21:16:01Z
Madison,0,0,0,29123,2020-04-02T21:16:01Z
Maries,2,0,2,29125,2020-04-02T21:16:01Z
Marion,0,0,0,29127,2020-04-02T21:16:01Z
McDonald,2,0,2,NA,2020-04-02T21:16:01Z
Mercer,0,0,0,29129,2020-04-02T21:16:01Z
Miller,0,0,0,29131,2020-04-02T21:16:01Z
Mississippi,0,0,0,29133,2020-04-02T21:16:01Z
Moniteau,2,0,2,29135,2020-04-02T21:16:01Z
Monroe,0,0,0,29137,2020-04-02T21:16:01Z
Montgomery,2,0,2,29139,2020-04-02T21:16:01Z
Morgan,1,0,1,29141,2020-04-02T21:16:01Z
New Madrid,1,0,1,29143,2020-04-02T21:16:01Z
Newton,6,3,3,29145,2020-04-02T21:16:01Z
Nodaway,0,0,0,29147,2020-04-02T21:16:01Z
Oregon,0,0,0,29149,2020-04-02T21:16:01Z
Osage,2,0,2,29151,2020-04-02T21:16:01Z
Ozark,0,0,0,29153,2020-04-02T21:16:01Z
Pemiscot,3,0,3,29155,2020-04-02T21:16:01Z
Perry,19,11,8,29157,2020-04-02T21:16:01Z
Pettis,1,0,1,29159,2020-04-02T21:16:01Z
Phelps,0,0,0,29161,2020-04-02T21:16:01Z
Pike,1,1,0,29163,2020-04-02T21:16:01Z
Platte,13,0,13,29165,2020-04-02T21:16:01Z
Polk,0,0,0,29167,2020-04-02T21:16:01Z
Pulaski,8,1,7,29169,2020-04-02T21:16:01Z
Putnam,0,0,0,29171,2020-04-02T21:16:01Z
Ralls,1,1,0,29173,2020-04-02T21:16:01Z
Randolph,2,0,2,29175,2020-04-02T21:16:01Z
Ray,1,0,1,29177,2020-04-02T21:16:01Z
Reynolds,2,1,1,29179,2020-04-02T21:16:01Z
Ripley,2,0,2,29181,2020-04-02T21:16:01Z
Saline,0,0,0,29195,2020-04-02T21:16:01Z
Schuyler,0,0,0,29197,2020-04-02T21:16:01Z
Scotland,0,0,0,29199,2020-04-02T21:16:01Z
Scott,6,1,5,29201,2020-04-02T21:16:01Z
Shannon,0,0,0,29203,2020-04-02T21:16:01Z
Shelby,1,1,0,29205,2020-04-02T21:16:01Z
St. Charles,105,12,93,29183,2020-04-02T21:16:01Z
St. Clair,0,0,0,29185,2020-04-02T21:16:01Z
St. Francois,9,1,8,29187,2020-04-02T21:16:01Z
St. Louis City,216,13,203,29510,2020-04-02T21:16:01Z
St. Louis,712,35,677,29189,2020-04-02T21:16:01Z
Ste. Genevieve,3,1,2,29186,2020-04-02T21:16:01Z
Stoddard,6,1,5,29207,2020-04-02T21:16:01Z
Stone,2,1,1,29209,2020-04-02T21:16:01Z
Sullivan,0,0,0,29211,2020-04-02T21:16:01Z
Taney,2,0,2,29213,2020-04-02T21:16:01Z
Texas,0,0,0,29215,2020-04-02T21:16:01Z
Vernon,0,0,0,29217,2020-04-02T21:16:01Z
Warren,7,0,7,29219,2020-04-02T21:16:01Z
Washington,0,0,0,29221,2020-04-02T21:16:01Z
Wayne,0,0,0,29223,2020-04-02T21:16:01Z
Webster,2,0,2,29225,2020-04-02T21:16:01Z
Worth,0,0,0,29227,2020-04-02T21:16:01Z
Wright,6,1,5,29229,2020-04-02T21:16:01Z
TBD,3,1,2,NA,2020-04-02T21:16:01Z
Adair,3,0,3,29001,2020-04-02T17:16:01Z
Andrew,0,0,0,29003,2020-04-02T17:16:01Z
Atchison,1,1,0,29005,2020-04-02T17:16:01Z
Audrain,0,0,0,29007,2020-04-02T17:16:01Z
Barry,1,0,1,29009,2020-04-02T17:16:01Z
Barton,0,0,0,29011,2020-04-02T17:16:01Z
Bates,2,0,2,29013,2020-04-02T17:16:01Z
Benton,3,0,3,29015,2020-04-02T17:16:01Z
Bollinger,1,0,1,29017,2020-04-02T17:16:01Z
Boone,65,1,64,29019,2020-04-02T17:16:01Z
Buchanan,5,1,4,29021,2020-04-02T17:16:01Z
Butler,1,0,1,29023,2020-04-02T17:16:01Z
Caldwell,1,0,1,29025,2020-04-02T17:16:01Z
Callaway,17,1,16,29027,2020-04-02T17:16:01Z
Camden,17,2,15,29029,2020-04-02T17:16:01Z
Cape Girardeau,15,0,15,29031,2020-04-02T17:16:01Z
Carroll,0,0,0,29033,2020-04-02T17:16:01Z
Carter,3,1,2,29035,2020-04-02T17:16:01Z
Cass,17,3,14,29037,2020-04-02T17:16:01Z
Cedar,3,0,3,29039,2020-04-02T17:16:01Z
Chariton,4,0,4,29041,2020-04-02T17:16:01Z
Christian,11,4,7,29043,2020-04-02T17:16:01Z
Clark,0,0,0,29045,2020-04-02T17:16:01Z
Clay,21,0,21,29047,2020-04-02T17:16:01Z
Clinton,5,0,5,29049,2020-04-02T17:16:01Z
Cole,24,3,21,29051,2020-04-02T17:16:01Z
Cooper,2,0,2,29053,2020-04-02T17:16:01Z
Crawford,1,0,1,29055,2020-04-02T17:16:01Z
Dade,0,0,0,29057,2020-04-02T17:16:01Z
Dallas,0,0,0,29059,2020-04-02T17:16:01Z
Daviess,0,0,0,29061,2020-04-02T17:16:01Z
DeKalb,1,0,1,NA,2020-04-02T17:16:01Z
Dent,0,0,0,29065,2020-04-02T17:16:01Z
Douglas,0,0,0,29067,2020-04-02T17:16:01Z
Dunklin,5,0,5,29069,2020-04-02T17:16:01Z
Franklin,16,0,16,29071,2020-04-02T17:16:01Z
Gasconade,1,0,1,29073,2020-04-02T17:16:01Z
Gentry,0,0,0,29075,2020-04-02T17:16:01Z
Greene,51,17,34,29077,2020-04-02T17:16:01Z
Grundy,0,0,0,29079,2020-04-02T17:16:01Z
Harrison,1,0,1,29081,2020-04-02T17:16:01Z
Henry,1,1,0,29083,2020-04-02T17:16:01Z
Hickory,0,0,0,29085,2020-04-02T17:16:01Z
Holt,0,0,0,29087,2020-04-02T17:16:01Z
Howard,0,0,0,29089,2020-04-02T17:16:01Z
Howell,0,0,0,29091,2020-04-02T17:16:01Z
Iron,0,0,0,29093,2020-04-02T17:16:01Z
Jackson,86,5,81,29095,2020-04-02T17:16:01Z
Jasper,5,1,4,29097,2020-04-02T17:16:01Z
Jefferson,38,4,34,29099,2020-04-02T17:16:01Z
Johnson,14,1,13,29101,2020-04-02T17:16:01Z
Joplin,1,0,1,NA,2020-04-02T17:16:01Z
Kansas City,128,2,126,NA,2020-04-02T17:16:01Z
Knox,0,0,0,29103,2020-04-02T17:16:01Z
Laclede,0,0,0,29105,2020-04-02T17:16:01Z
Lafayette,20,0,20,29107,2020-04-02T17:16:01Z
Lawrence,0,0,0,29109,2020-04-02T17:16:01Z
Lewis,0,0,0,29111,2020-04-02T17:16:01Z
Lincoln,10,2,8,29113,2020-04-02T17:16:01Z
Linn,0,0,0,29115,2020-04-02T17:16:01Z
Livingston,1,0,1,29117,2020-04-02T17:16:01Z
Macon,2,0,2,29121,2020-04-02T17:16:01Z
Madison,0,0,0,29123,2020-04-02T17:16:01Z
Maries,2,0,2,29125,2020-04-02T17:16:01Z
Marion,0,0,0,29127,2020-04-02T17:16:01Z
McDonald,2,0,2,NA,2020-04-02T17:16:01Z
Mercer,0,0,0,29129,2020-04-02T17:16:01Z
Miller,0,0,0,29131,2020-04-02T17:16:01Z
Mississippi,0,0,0,29133,2020-04-02T17:16:01Z
Moniteau,2,0,2,29135,2020-04-02T17:16:01Z
Monroe,0,0,0,29137,2020-04-02T17:16:01Z
Montgomery,2,0,2,29139,2020-04-02T17:16:01Z
Morgan,1,0,1,29141,2020-04-02T17:16:01Z
New Madrid,0,0,0,29143,2020-04-02T17:16:01Z
Newton,5,3,2,29145,2020-04-02T17:16:01Z
Nodaway,0,0,0,29147,2020-04-02T17:16:01Z
Oregon,0,0,0,29149,2020-04-02T17:16:01Z
Osage,2,0,2,29151,2020-04-02T17:16:01Z
Ozark,0,0,0,29153,2020-04-02T17:16:01Z
Pemiscot,2,0,2,29155,2020-04-02T17:16:01Z
Perry,18,11,7,29157,2020-04-02T17:16:01Z
Pettis,1,0,1,29159,2020-04-02T17:16:01Z
Phelps,0,0,0,29161,2020-04-02T17:16:01Z
Pike,1,1,0,29163,2020-04-02T17:16:01Z
Platte,12,0,12,29165,2020-04-02T17:16:01Z
Polk,0,0,0,29167,2020-04-02T17:16:01Z
Pulaski,8,1,7,29169,2020-04-02T17:16:01Z
Putnam,0,0,0,29171,2020-04-02T17:16:01Z
Ralls,1,1,0,29173,2020-04-02T17:16:01Z
Randolph,2,0,2,29175,2020-04-02T17:16:01Z
Ray,1,0,1,29177,2020-04-02T17:16:01Z
Reynolds,2,1,1,29179,2020-04-02T17:16:01Z
Ripley,2,0,2,29181,2020-04-02T17:16:01Z
Saline,0,0,0,29195,2020-04-02T17:16:01Z
Schuyler,0,0,0,29197,2020-04-02T17:16:01Z
Scotland,0,0,0,29199,2020-04-02T17:16:01Z
Scott,6,1,5,29201,2020-04-02T17:16:01Z
Shannon,0,0,0,29203,2020-04-02T17:16:01Z
Shelby,1,1,0,29205,2020-04-02T17:16:01Z
St. Charles,93,12,81,29183,2020-04-02T17:16:01Z
St. Clair,0,0,0,29185,2020-04-02T17:16:01Z
St. Francois,6,1,5,29187,2020-04-02T17:16:01Z
St. Louis City,176,12,164,29510,2020-04-02T17:16:01Z
St. Louis,605,37,568,29189,2020-04-02T17:16:01Z
Ste. Genevieve,3,1,2,29186,2020-04-02T17:16:01Z
Stoddard,3,0,3,29207,2020-04-02T17:16:01Z
Stone,2,1,1,29209,2020-04-02T17:16:01Z
Sullivan,0,0,0,29211,2020-04-02T17:16:01Z
Taney,2,0,2,29213,2020-04-02T17:16:01Z
Texas,0,0,0,29215,2020-04-02T17:16:01Z
Vernon,0,0,0,29217,2020-04-02T17:16:01Z
Warren,6,0,6,29219,2020-04-02T17:16:01Z
Washington,0,0,0,29221,2020-04-02T17:16:01Z
Wayne,0,0,0,29223,2020-04-02T17:16:01Z
Webster,2,0,2,29225,2020-04-02T17:16:01Z
Worth,0,0,0,29227,2020-04-02T17:16:01Z
Wright,4,1,3,29229,2020-04-02T17:16:01Z
TBD,2,0,2,NA,2020-04-02T17:16:01Z
Adair,3,0,3,29001,2020-04-02T13:16:01Z
Andrew,0,0,0,29003,2020-04-02T13:16:01Z
Atchison,1,1,0,29005,2020-04-02T13:16:01Z
Audrain,0,0,0,29007,2020-04-02T13:16:01Z
Barry,1,0,1,29009,2020-04-02T13:16:01Z
Barton,0,0,0,29011,2020-04-02T13:16:01Z
Bates,2,0,2,29013,2020-04-02T13:16:01Z
Benton,3,0,3,29015,2020-04-02T13:16:01Z
Bollinger,1,0,1,29017,2020-04-02T13:16:01Z
Boone,65,1,64,29019,2020-04-02T13:16:01Z
Buchanan,5,1,4,29021,2020-04-02T13:16:01Z
Butler,1,0,1,29023,2020-04-02T13:16:01Z
Caldwell,1,0,1,29025,2020-04-02T13:16:01Z
Callaway,17,1,16,29027,2020-04-02T13:16:01Z
Camden,17,2,15,29029,2020-04-02T13:16:01Z
Cape Girardeau,15,0,15,29031,2020-04-02T13:16:01Z
Carroll,0,0,0,29033,2020-04-02T13:16:01Z
Carter,3,1,2,29035,2020-04-02T13:16:01Z
Cass,17,3,14,29037,2020-04-02T13:16:01Z
Cedar,3,0,3,29039,2020-04-02T13:16:01Z
Chariton,4,0,4,29041,2020-04-02T13:16:01Z
Christian,11,4,7,29043,2020-04-02T13:16:01Z
Clark,0,0,0,29045,2020-04-02T13:16:01Z
Clay,21,0,21,29047,2020-04-02T13:16:01Z
Clinton,5,0,5,29049,2020-04-02T13:16:01Z
Cole,24,3,21,29051,2020-04-02T13:16:01Z
Cooper,2,0,2,29053,2020-04-02T13:16:01Z
Crawford,1,0,1,29055,2020-04-02T13:16:01Z
Dade,0,0,0,29057,2020-04-02T13:16:01Z
Dallas,0,0,0,29059,2020-04-02T13:16:01Z
Daviess,0,0,0,29061,2020-04-02T13:16:01Z
DeKalb,1,0,1,NA,2020-04-02T13:16:01Z
Dent,0,0,0,29065,2020-04-02T13:16:01Z
Douglas,0,0,0,29067,2020-04-02T13:16:01Z
Dunklin,5,0,5,29069,2020-04-02T13:16:01Z
Franklin,16,0,16,29071,2020-04-02T13:16:01Z
Gasconade,1,0,1,29073,2020-04-02T13:16:01Z
Gentry,0,0,0,29075,2020-04-02T13:16:01Z
Greene,51,17,34,29077,2020-04-02T13:16:01Z
Grundy,0,0,0,29079,2020-04-02T13:16:01Z
Harrison,1,0,1,29081,2020-04-02T13:16:01Z
Henry,1,1,0,29083,2020-04-02T13:16:01Z
Hickory,0,0,0,29085,2020-04-02T13:16:01Z
Holt,0,0,0,29087,2020-04-02T13:16:01Z
Howard,0,0,0,29089,2020-04-02T13:16:01Z
Howell,0,0,0,29091,2020-04-02T13:16:01Z
Iron,0,0,0,29093,2020-04-02T13:16:01Z
Jackson,86,5,81,29095,2020-04-02T13:16:01Z
Jasper,5,1,4,29097,2020-04-02T13:16:01Z
Jefferson,38,4,34,29099,2020-04-02T13:16:01Z
Johnson,14,1,13,29101,2020-04-02T13:16:01Z
Joplin,1,0,1,NA,2020-04-02T13:16:01Z
Kansas City,128,2,126,NA,2020-04-02T13:16:01Z
Knox,0,0,0,29103,2020-04-02T13:16:01Z
Laclede,0,0,0,29105,2020-04-02T13:16:01Z
Lafayette,20,0,20,29107,2020-04-02T13:16:01Z
Lawrence,0,0,0,29109,2020-04-02T13:16:01Z
Lewis,0,0,0,29111,2020-04-02T13:16:01Z
Lincoln,10,2,8,29113,2020-04-02T13:16:01Z
Linn,0,0,0,29115,2020-04-02T13:16:01Z
Livingston,1,0,1,29117,2020-04-02T13:16:01Z
Macon,2,0,2,29121,2020-04-02T13:16:01Z
Madison,0,0,0,29123,2020-04-02T13:16:01Z
Maries,2,0,2,29125,2020-04-02T13:16:01Z
Marion,0,0,0,29127,2020-04-02T13:16:01Z
McDonald,2,0,2,NA,2020-04-02T13:16:01Z
Mercer,0,0,0,29129,2020-04-02T13:16:01Z
Miller,0,0,0,29131,2020-04-02T13:16:01Z
Mississippi,0,0,0,29133,2020-04-02T13:16:01Z
Moniteau,2,0,2,29135,2020-04-02T13:16:01Z
Monroe,0,0,0,29137,2020-04-02T13:16:01Z
Montgomery,2,0,2,29139,2020-04-02T13:16:01Z
Morgan,1,0,1,29141,2020-04-02T13:16:01Z
New Madrid,0,0,0,29143,2020-04-02T13:16:01Z
Newton,5,3,2,29145,2020-04-02T13:16:01Z
Nodaway,0,0,0,29147,2020-04-02T13:16:01Z
Oregon,0,0,0,29149,2020-04-02T13:16:01Z
Osage,2,0,2,29151,2020-04-02T13:16:01Z
Ozark,0,0,0,29153,2020-04-02T13:16:01Z
Pemiscot,2,0,2,29155,2020-04-02T13:16:01Z
Perry,18,11,7,29157,2020-04-02T13:16:01Z
Pettis,1,0,1,29159,2020-04-02T13:16:01Z
Phelps,0,0,0,29161,2020-04-02T13:16:01Z
Pike,1,1,0,29163,2020-04-02T13:16:01Z
Platte,12,0,12,29165,2020-04-02T13:16:01Z
Polk,0,0,0,29167,2020-04-02T13:16:01Z
Pulaski,8,1,7,29169,2020-04-02T13:16:01Z
Putnam,0,0,0,29171,2020-04-02T13:16:01Z
Ralls,1,1,0,29173,2020-04-02T13:16:01Z
Randolph,2,0,2,29175,2020-04-02T13:16:01Z
Ray,1,0,1,29177,2020-04-02T13:16:01Z
Reynolds,2,1,1,29179,2020-04-02T13:16:01Z
Ripley,2,0,2,29181,2020-04-02T13:16:01Z
Saline,0,0,0,29195,2020-04-02T13:16:01Z
Schuyler,0,0,0,29197,2020-04-02T13:16:01Z
Scotland,0,0,0,29199,2020-04-02T13:16:01Z
Scott,6,1,5,29201,2020-04-02T13:16:01Z
Shannon,0,0,0,29203,2020-04-02T13:16:01Z
Shelby,1,1,0,29205,2020-04-02T13:16:01Z
St. Charles,93,12,81,29183,2020-04-02T13:16:01Z
St. Clair,0,0,0,29185,2020-04-02T13:16:01Z
St. Francois,6,1,5,29187,2020-04-02T13:16:01Z
St. Louis City,176,12,164,29510,2020-04-02T13:16:01Z
St. Louis,605,37,568,29189,2020-04-02T13:16:01Z
Ste. Genevieve,3,1,2,29186,2020-04-02T13:16:01Z
Stoddard,3,0,3,29207,2020-04-02T13:16:01Z
Stone,2,1,1,29209,2020-04-02T13:16:01Z
Sullivan,0,0,0,29211,2020-04-02T13:16:01Z
Taney,2,0,2,29213,2020-04-02T13:16:01Z
Texas,0,0,0,29215,2020-04-02T13:16:01Z
Vernon,0,0,0,29217,2020-04-02T13:16:01Z
Warren,6,0,6,29219,2020-04-02T13:16:01Z
Washington,0,0,0,29221,2020-04-02T13:16:01Z
Wayne,0,0,0,29223,2020-04-02T13:16:01Z
Webster,2,0,2,29225,2020-04-02T13:16:01Z
Worth,0,0,0,29227,2020-04-02T13:16:01Z
Wright,4,1,3,29229,2020-04-02T13:16:01Z
TBD,2,0,2,NA,2020-04-02T13:16:01Z
Adair,3,0,3,29001,2020-04-02T01:16:02Z
Andrew,0,0,0,29003,2020-04-02T01:16:02Z
Atchison,1,1,0,29005,2020-04-02T01:16:02Z
Audrain,0,0,0,29007,2020-04-02T01:16:02Z
Barry,1,0,1,29009,2020-04-02T01:16:02Z
Barton,0,0,0,29011,2020-04-02T01:16:02Z
Bates,2,0,2,29013,2020-04-02T01:16:02Z
Benton,3,0,3,29015,2020-04-02T01:16:02Z
Bollinger,1,0,1,29017,2020-04-02T01:16:02Z
Boone,65,1,64,29019,2020-04-02T01:16:02Z
Buchanan,5,1,4,29021,2020-04-02T01:16:02Z
Butler,1,0,1,29023,2020-04-02T01:16:02Z
Caldwell,1,0,1,29025,2020-04-02T01:16:02Z
Callaway,17,1,16,29027,2020-04-02T01:16:02Z
Camden,17,2,15,29029,2020-04-02T01:16:02Z
Cape Girardeau,15,0,15,29031,2020-04-02T01:16:02Z
Carroll,0,0,0,29033,2020-04-02T01:16:02Z
Carter,3,1,2,29035,2020-04-02T01:16:02Z
Cass,17,3,14,29037,2020-04-02T01:16:02Z
Cedar,3,0,3,29039,2020-04-02T01:16:02Z
Chariton,4,0,4,29041,2020-04-02T01:16:02Z
Christian,11,4,7,29043,2020-04-02T01:16:02Z
Clark,0,0,0,29045,2020-04-02T01:16:02Z
Clay,21,0,21,29047,2020-04-02T01:16:02Z
Clinton,5,0,5,29049,2020-04-02T01:16:02Z
Cole,24,3,21,29051,2020-04-02T01:16:02Z
Cooper,2,0,2,29053,2020-04-02T01:16:02Z
Crawford,1,0,1,29055,2020-04-02T01:16:02Z
Dade,0,0,0,29057,2020-04-02T01:16:02Z
Dallas,0,0,0,29059,2020-04-02T01:16:02Z
Daviess,0,0,0,29061,2020-04-02T01:16:02Z
DeKalb,1,0,1,NA,2020-04-02T01:16:02Z
Dent,0,0,0,29065,2020-04-02T01:16:02Z
Douglas,0,0,0,29067,2020-04-02T01:16:02Z
Dunklin,5,0,5,29069,2020-04-02T01:16:02Z
Franklin,16,0,16,29071,2020-04-02T01:16:02Z
Gasconade,1,0,1,29073,2020-04-02T01:16:02Z
Gentry,0,0,0,29075,2020-04-02T01:16:02Z
Greene,51,17,34,29077,2020-04-02T01:16:02Z
Grundy,0,0,0,29079,2020-04-02T01:16:02Z
Harrison,1,0,1,29081,2020-04-02T01:16:02Z
Henry,1,1,0,29083,2020-04-02T01:16:02Z
Hickory,0,0,0,29085,2020-04-02T01:16:02Z
Holt,0,0,0,29087,2020-04-02T01:16:02Z
Howard,0,0,0,29089,2020-04-02T01:16:02Z
Howell,0,0,0,29091,2020-04-02T01:16:02Z
Iron,0,0,0,29093,2020-04-02T01:16:02Z
Jackson,86,5,81,29095,2020-04-02T01:16:02Z
Jasper,5,1,4,29097,2020-04-02T01:16:02Z
Jefferson,38,4,34,29099,2020-04-02T01:16:02Z
Johnson,14,1,13,29101,2020-04-02T01:16:02Z
Joplin,1,0,1,NA,2020-04-02T01:16:02Z
Kansas City,128,2,126,NA,2020-04-02T01:16:02Z
Knox,0,0,0,29103,2020-04-02T01:16:02Z
Laclede,0,0,0,29105,2020-04-02T01:16:02Z
Lafayette,20,0,20,29107,2020-04-02T01:16:02Z
Lawrence,0,0,0,29109,2020-04-02T01:16:02Z
Lewis,0,0,0,29111,2020-04-02T01:16:02Z
Lincoln,10,2,8,29113,2020-04-02T01:16:02Z
Linn,0,0,0,29115,2020-04-02T01:16:02Z
Livingston,1,0,1,29117,2020-04-02T01:16:02Z
Macon,2,0,2,29121,2020-04-02T01:16:02Z
Madison,0,0,0,29123,2020-04-02T01:16:02Z
Maries,2,0,2,29125,2020-04-02T01:16:02Z
Marion,0,0,0,29127,2020-04-02T01:16:02Z
McDonald,2,0,2,NA,2020-04-02T01:16:02Z
Mercer,0,0,0,29129,2020-04-02T01:16:02Z
Miller,0,0,0,29131,2020-04-02T01:16:02Z
Mississippi,0,0,0,29133,2020-04-02T01:16:02Z
Moniteau,2,0,2,29135,2020-04-02T01:16:02Z
Monroe,0,0,0,29137,2020-04-02T01:16:02Z
Montgomery,2,0,2,29139,2020-04-02T01:16:02Z
Morgan,1,0,1,29141,2020-04-02T01:16:02Z
New Madrid,0,0,0,29143,2020-04-02T01:16:02Z
Newton,5,3,2,29145,2020-04-02T01:16:02Z
Nodaway,0,0,0,29147,2020-04-02T01:16:02Z
Oregon,0,0,0,29149,2020-04-02T01:16:02Z
Osage,2,0,2,29151,2020-04-02T01:16:02Z
Ozark,0,0,0,29153,2020-04-02T01:16:02Z
Pemiscot,2,0,2,29155,2020-04-02T01:16:02Z
Perry,18,11,7,29157,2020-04-02T01:16:02Z
Pettis,1,0,1,29159,2020-04-02T01:16:02Z
Phelps,0,0,0,29161,2020-04-02T01:16:02Z
Pike,1,1,0,29163,2020-04-02T01:16:02Z
Platte,12,0,12,29165,2020-04-02T01:16:02Z
Polk,0,0,0,29167,2020-04-02T01:16:02Z
Pulaski,8,1,7,29169,2020-04-02T01:16:02Z
Putnam,0,0,0,29171,2020-04-02T01:16:02Z
Ralls,1,1,0,29173,2020-04-02T01:16:02Z
Randolph,2,0,2,29175,2020-04-02T01:16:02Z
Ray,1,0,1,29177,2020-04-02T01:16:02Z
Reynolds,2,1,1,29179,2020-04-02T01:16:02Z
Ripley,2,0,2,29181,2020-04-02T01:16:02Z
Saline,0,0,0,29195,2020-04-02T01:16:02Z
Schuyler,0,0,0,29197,2020-04-02T01:16:02Z
Scotland,0,0,0,29199,2020-04-02T01:16:02Z
Scott,6,1,5,29201,2020-04-02T01:16:02Z
Shannon,0,0,0,29203,2020-04-02T01:16:02Z
Shelby,1,1,0,29205,2020-04-02T01:16:02Z
St. Charles,93,12,81,29183,2020-04-02T01:16:02Z
St. Clair,0,0,0,29185,2020-04-02T01:16:02Z
St. Francois,6,1,5,29187,2020-04-02T01:16:02Z
St. Louis City,176,12,164,29510,2020-04-02T01:16:02Z
St. Louis,605,37,568,29189,2020-04-02T01:16:02Z
Ste. Genevieve,3,1,2,29186,2020-04-02T01:16:02Z
Stoddard,3,0,3,29207,2020-04-02T01:16:02Z
Stone,2,1,1,29209,2020-04-02T01:16:02Z
Sullivan,0,0,0,29211,2020-04-02T01:16:02Z
Taney,2,0,2,29213,2020-04-02T01:16:02Z
Texas,0,0,0,29215,2020-04-02T01:16:02Z
Vernon,0,0,0,29217,2020-04-02T01:16:02Z
Warren,6,0,6,29219,2020-04-02T01:16:02Z
Washington,0,0,0,29221,2020-04-02T01:16:02Z
Wayne,0,0,0,29223,2020-04-02T01:16:02Z
Webster,2,0,2,29225,2020-04-02T01:16:02Z
Worth,0,0,0,29227,2020-04-02T01:16:02Z
Wright,4,1,3,29229,2020-04-02T01:16:02Z
TBD,2,0,2,NA,2020-04-02T01:16:02Z
Adair,3,0,3,29001,2020-04-01T21:16:01Z
Andrew,0,0,0,29003,2020-04-01T21:16:01Z
Atchison,1,1,0,29005,2020-04-01T21:16:01Z
Audrain,0,0,0,29007,2020-04-01T21:16:01Z
Barry,1,0,1,29009,2020-04-01T21:16:01Z
Barton,0,0,0,29011,2020-04-01T21:16:01Z
Bates,2,0,2,29013,2020-04-01T21:16:01Z
Benton,3,0,3,29015,2020-04-01T21:16:01Z
Bollinger,1,0,1,29017,2020-04-01T21:16:01Z
Boone,65,1,64,29019,2020-04-01T21:16:01Z
Buchanan,5,1,4,29021,2020-04-01T21:16:01Z
Butler,1,0,1,29023,2020-04-01T21:16:01Z
Caldwell,1,0,1,29025,2020-04-01T21:16:01Z
Callaway,17,1,16,29027,2020-04-01T21:16:01Z
Camden,17,2,15,29029,2020-04-01T21:16:01Z
Cape Girardeau,15,0,15,29031,2020-04-01T21:16:01Z
Carroll,0,0,0,29033,2020-04-01T21:16:01Z
Carter,3,1,2,29035,2020-04-01T21:16:01Z
Cass,17,3,14,29037,2020-04-01T21:16:01Z
Cedar,3,0,3,29039,2020-04-01T21:16:01Z
Chariton,4,0,4,29041,2020-04-01T21:16:01Z
Christian,11,4,7,29043,2020-04-01T21:16:01Z
Clark,0,0,0,29045,2020-04-01T21:16:01Z
Clay,21,0,21,29047,2020-04-01T21:16:01Z
Clinton,5,0,5,29049,2020-04-01T21:16:01Z
Cole,24,3,21,29051,2020-04-01T21:16:01Z
Cooper,2,0,2,29053,2020-04-01T21:16:01Z
Crawford,1,0,1,29055,2020-04-01T21:16:01Z
Dade,0,0,0,29057,2020-04-01T21:16:01Z
Dallas,0,0,0,29059,2020-04-01T21:16:01Z
Daviess,0,0,0,29061,2020-04-01T21:16:01Z
DeKalb,1,0,1,NA,2020-04-01T21:16:01Z
Dent,0,0,0,29065,2020-04-01T21:16:01Z
Douglas,0,0,0,29067,2020-04-01T21:16:01Z
Dunklin,5,0,5,29069,2020-04-01T21:16:01Z
Franklin,16,0,16,29071,2020-04-01T21:16:01Z
Gasconade,1,0,1,29073,2020-04-01T21:16:01Z
Gentry,0,0,0,29075,2020-04-01T21:16:01Z
Greene,51,17,34,29077,2020-04-01T21:16:01Z
Grundy,0,0,0,29079,2020-04-01T21:16:01Z
Harrison,1,0,1,29081,2020-04-01T21:16:01Z
Henry,1,1,0,29083,2020-04-01T21:16:01Z
Hickory,0,0,0,29085,2020-04-01T21:16:01Z
Holt,0,0,0,29087,2020-04-01T21:16:01Z
Howard,0,0,0,29089,2020-04-01T21:16:01Z
Howell,0,0,0,29091,2020-04-01T21:16:01Z
Iron,0,0,0,29093,2020-04-01T21:16:01Z
Jackson,86,5,81,29095,2020-04-01T21:16:01Z
Jasper,5,1,4,29097,2020-04-01T21:16:01Z
Jefferson,38,4,34,29099,2020-04-01T21:16:01Z
Johnson,14,1,13,29101,2020-04-01T21:16:01Z
Joplin,1,0,1,NA,2020-04-01T21:16:01Z
Kansas City,128,2,126,NA,2020-04-01T21:16:01Z
Knox,0,0,0,29103,2020-04-01T21:16:01Z
Laclede,0,0,0,29105,2020-04-01T21:16:01Z
Lafayette,20,0,20,29107,2020-04-01T21:16:01Z
Lawrence,0,0,0,29109,2020-04-01T21:16:01Z
Lewis,0,0,0,29111,2020-04-01T21:16:01Z
Lincoln,10,2,8,29113,2020-04-01T21:16:01Z
Linn,0,0,0,29115,2020-04-01T21:16:01Z
Livingston,1,0,1,29117,2020-04-01T21:16:01Z
Macon,2,0,2,29121,2020-04-01T21:16:01Z
Madison,0,0,0,29123,2020-04-01T21:16:01Z
Maries,2,0,2,29125,2020-04-01T21:16:01Z
Marion,0,0,0,29127,2020-04-01T21:16:01Z
McDonald,2,0,2,NA,2020-04-01T21:16:01Z
Mercer,0,0,0,29129,2020-04-01T21:16:01Z
Miller,0,0,0,29131,2020-04-01T21:16:01Z
Mississippi,0,0,0,29133,2020-04-01T21:16:01Z
Moniteau,2,0,2,29135,2020-04-01T21:16:01Z
Monroe,0,0,0,29137,2020-04-01T21:16:01Z
Montgomery,2,0,2,29139,2020-04-01T21:16:01Z
Morgan,1,0,1,29141,2020-04-01T21:16:01Z
New Madrid,0,0,0,29143,2020-04-01T21:16:01Z
Newton,5,3,2,29145,2020-04-01T21:16:01Z
Nodaway,0,0,0,29147,2020-04-01T21:16:01Z
Oregon,0,0,0,29149,2020-04-01T21:16:01Z
Osage,2,0,2,29151,2020-04-01T21:16:01Z
Ozark,0,0,0,29153,2020-04-01T21:16:01Z
Pemiscot,2,0,2,29155,2020-04-01T21:16:01Z
Perry,18,11,7,29157,2020-04-01T21:16:01Z
Pettis,1,0,1,29159,2020-04-01T21:16:01Z
Phelps,0,0,0,29161,2020-04-01T21:16:01Z
Pike,1,1,0,29163,2020-04-01T21:16:01Z
Platte,12,0,12,29165,2020-04-01T21:16:01Z
Polk,0,0,0,29167,2020-04-01T21:16:01Z
Pulaski,8,1,7,29169,2020-04-01T21:16:01Z
Putnam,0,0,0,29171,2020-04-01T21:16:01Z
Ralls,1,1,0,29173,2020-04-01T21:16:01Z
Randolph,2,0,2,29175,2020-04-01T21:16:01Z
Ray,1,0,1,29177,2020-04-01T21:16:01Z
Reynolds,2,1,1,29179,2020-04-01T21:16:01Z
Ripley,2,0,2,29181,2020-04-01T21:16:01Z
Saline,0,0,0,29195,2020-04-01T21:16:01Z
Schuyler,0,0,0,29197,2020-04-01T21:16:01Z
Scotland,0,0,0,29199,2020-04-01T21:16:01Z
Scott,6,1,5,29201,2020-04-01T21:16:01Z
Shannon,0,0,0,29203,2020-04-01T21:16:01Z
Shelby,1,1,0,29205,2020-04-01T21:16:01Z
St. Charles,93,12,81,29183,2020-04-01T21:16:01Z
St. Clair,0,0,0,29185,2020-04-01T21:16:01Z
St. Francois,6,1,5,29187,2020-04-01T21:16:01Z
St. Louis City,176,12,164,29510,2020-04-01T21:16:01Z
St. Louis,605,37,568,29189,2020-04-01T21:16:01Z
Ste. Genevieve,3,1,2,29186,2020-04-01T21:16:01Z
Stoddard,3,0,3,29207,2020-04-01T21:16:01Z
Stone,2,1,1,29209,2020-04-01T21:16:01Z
Sullivan,0,0,0,29211,2020-04-01T21:16:01Z
Taney,2,0,2,29213,2020-04-01T21:16:01Z
Texas,0,0,0,29215,2020-04-01T21:16:01Z
Vernon,0,0,0,29217,2020-04-01T21:16:01Z
Warren,6,0,6,29219,2020-04-01T21:16:01Z
Washington,0,0,0,29221,2020-04-01T21:16:01Z
Wayne,0,0,0,29223,2020-04-01T21:16:01Z
Webster,2,0,2,29225,2020-04-01T21:16:01Z
Worth,0,0,0,29227,2020-04-01T21:16:01Z
Wright,4,1,3,29229,2020-04-01T21:16:01Z
TBD,2,0,2,NA,2020-04-01T21:16:01Z
Adair,2,0,2,29001,2020-04-01T17:16:02Z
Andrew,0,0,0,29003,2020-04-01T17:16:02Z
Atchison,1,1,0,29005,2020-04-01T17:16:02Z
Audrain,0,0,0,29007,2020-04-01T17:16:02Z
Barry,1,0,1,29009,2020-04-01T17:16:02Z
Barton,0,0,0,29011,2020-04-01T17:16:02Z
Bates,1,0,1,29013,2020-04-01T17:16:02Z
Benton,2,0,2,29015,2020-04-01T17:16:02Z
Bollinger,1,0,1,29017,2020-04-01T17:16:02Z
Boone,64,3,61,29019,2020-04-01T17:16:02Z
Buchanan,5,0,5,29021,2020-04-01T17:16:02Z
Butler,0,0,0,29023,2020-04-01T17:16:02Z
Caldwell,0,0,0,29025,2020-04-01T17:16:02Z
Callaway,14,1,13,29027,2020-04-01T17:16:02Z
Camden,12,2,10,29029,2020-04-01T17:16:02Z
Cape Girardeau,15,0,15,29031,2020-04-01T17:16:02Z
Carroll,0,0,0,29033,2020-04-01T17:16:02Z
Carter,4,1,3,29035,2020-04-01T17:16:02Z
Cass,14,3,11,29037,2020-04-01T17:16:02Z
Cedar,3,0,3,29039,2020-04-01T17:16:02Z
Chariton,4,0,4,29041,2020-04-01T17:16:02Z
Christian,11,4,7,29043,2020-04-01T17:16:02Z
Clark,0,0,0,29045,2020-04-01T17:16:02Z
Clay,16,0,16,29047,2020-04-01T17:16:02Z
Clinton,4,0,4,29049,2020-04-01T17:16:02Z
Cole,23,3,20,29051,2020-04-01T17:16:02Z
Cooper,2,0,2,29053,2020-04-01T17:16:02Z
Crawford,1,0,1,29055,2020-04-01T17:16:02Z
Dade,0,0,0,29057,2020-04-01T17:16:02Z
Dallas,0,0,0,29059,2020-04-01T17:16:02Z
Daviess,0,0,0,29061,2020-04-01T17:16:02Z
DeKalb,0,0,0,NA,2020-04-01T17:16:02Z
Dent,0,0,0,29065,2020-04-01T17:16:02Z
Douglas,0,0,0,29067,2020-04-01T17:16:02Z
Dunklin,5,0,5,29069,2020-04-01T17:16:02Z
Franklin,13,0,13,29071,2020-04-01T17:16:02Z
Gasconade,0,0,0,29073,2020-04-01T17:16:02Z
Gentry,0,0,0,29075,2020-04-01T17:16:02Z
Greene,48,17,31,29077,2020-04-01T17:16:02Z
Grundy,0,0,0,29079,2020-04-01T17:16:02Z
Harrison,1,0,1,29081,2020-04-01T17:16:02Z
Henry,1,1,0,29083,2020-04-01T17:16:02Z
Hickory,0,0,0,29085,2020-04-01T17:16:02Z
Holt,0,0,0,29087,2020-04-01T17:16:02Z
Howard,0,0,0,29089,2020-04-01T17:16:02Z
Howell,0,0,0,29091,2020-04-01T17:16:02Z
Iron,0,0,0,29093,2020-04-01T17:16:02Z
Jackson,77,5,72,29095,2020-04-01T17:16:02Z
Jasper,4,1,3,29097,2020-04-01T17:16:02Z
Jefferson,30,3,27,29099,2020-04-01T17:16:02Z
Johnson,10,1,9,29101,2020-04-01T17:16:02Z
Joplin,2,0,2,NA,2020-04-01T17:16:02Z
Kansas City,119,2,117,NA,2020-04-01T17:16:02Z
Knox,0,0,0,29103,2020-04-01T17:16:02Z
Laclede,0,0,0,29105,2020-04-01T17:16:02Z
Lafayette,19,0,19,29107,2020-04-01T17:16:02Z
Lawrence,0,0,0,29109,2020-04-01T17:16:02Z
Lewis,0,0,0,29111,2020-04-01T17:16:02Z
Lincoln,7,1,6,29113,2020-04-01T17:16:02Z
Linn,0,0,0,29115,2020-04-01T17:16:02Z
Livingston,1,0,1,29117,2020-04-01T17:16:02Z
Macon,3,0,3,29121,2020-04-01T17:16:02Z
Madison,0,0,0,29123,2020-04-01T17:16:02Z
Maries,1,0,1,29125,2020-04-01T17:16:02Z
Marion,0,0,0,29127,2020-04-01T17:16:02Z
McDonald,2,0,2,NA,2020-04-01T17:16:02Z
Mercer,0,0,0,29129,2020-04-01T17:16:02Z
Miller,0,0,0,29131,2020-04-01T17:16:02Z
Mississippi,0,0,0,29133,2020-04-01T17:16:02Z
Moniteau,2,0,2,29135,2020-04-01T17:16:02Z
Monroe,0,0,0,29137,2020-04-01T17:16:02Z
Montgomery,2,0,2,29139,2020-04-01T17:16:02Z
Morgan,1,0,1,29141,2020-04-01T17:16:02Z
New Madrid,0,0,0,29143,2020-04-01T17:16:02Z
Newton,5,3,2,29145,2020-04-01T17:16:02Z
Nodaway,0,0,0,29147,2020-04-01T17:16:02Z
Oregon,0,0,0,29149,2020-04-01T17:16:02Z
Osage,1,0,1,29151,2020-04-01T17:16:02Z
Ozark,0,0,0,29153,2020-04-01T17:16:02Z
Pemiscot,2,0,2,29155,2020-04-01T17:16:02Z
Perry,14,9,5,29157,2020-04-01T17:16:02Z
Pettis,1,0,1,29159,2020-04-01T17:16:02Z
Phelps,0,0,0,29161,2020-04-01T17:16:02Z
Pike,1,1,0,29163,2020-04-01T17:16:02Z
Platte,9,0,9,29165,2020-04-01T17:16:02Z
Polk,0,0,0,29167,2020-04-01T17:16:02Z
Pulaski,7,1,6,29169,2020-04-01T17:16:02Z
Putnam,0,0,0,29171,2020-04-01T17:16:02Z
Ralls,1,1,0,29173,2020-04-01T17:16:02Z
Randolph,2,0,2,29175,2020-04-01T17:16:02Z
Ray,1,0,1,29177,2020-04-01T17:16:02Z
Reynolds,2,1,1,29179,2020-04-01T17:16:02Z
Ripley,2,0,2,29181,2020-04-01T17:16:02Z
Saline,0,0,0,29195,2020-04-01T17:16:02Z
Schuyler,0,0,0,29197,2020-04-01T17:16:02Z
Scotland,0,0,0,29199,2020-04-01T17:16:02Z
Scott,6,1,5,29201,2020-04-01T17:16:02Z
Shannon,0,0,0,29203,2020-04-01T17:16:02Z
Shelby,1,1,0,29205,2020-04-01T17:16:02Z
St. Charles,71,11,60,29183,2020-04-01T17:16:02Z
St. Clair,0,0,0,29185,2020-04-01T17:16:02Z
St. Francois,5,1,4,29187,2020-04-01T17:16:02Z
St. Louis City,136,11,125,29510,2020-04-01T17:16:02Z
St. Louis,492,29,463,29189,2020-04-01T17:16:02Z
Ste. Genevieve,2,0,2,29186,2020-04-01T17:16:02Z
Stoddard,3,0,3,29207,2020-04-01T17:16:02Z
Stone,1,1,0,29209,2020-04-01T17:16:02Z
Sullivan,0,0,0,29211,2020-04-01T17:16:02Z
Taney,2,0,2,29213,2020-04-01T17:16:02Z
Texas,0,0,0,29215,2020-04-01T17:16:02Z
Vernon,0,0,0,29217,2020-04-01T17:16:02Z
Warren,5,0,5,29219,2020-04-01T17:16:02Z
Washington,0,0,0,29221,2020-04-01T17:16:02Z
Wayne,0,0,0,29223,2020-04-01T17:16:02Z
Webster,2,0,2,29225,2020-04-01T17:16:02Z
Worth,0,0,0,29227,2020-04-01T17:16:02Z
Wright,4,1,3,29229,2020-04-01T17:16:02Z
TBD,1,0,1,NA,2020-04-01T17:16:02Z
Adair,1,0,1,29001,2020-03-31T17:16:01Z
Andrew,0,0,0,29003,2020-03-31T17:16:01Z
Atchison,1,1,0,29005,2020-03-31T17:16:01Z
Audrain,0,0,0,29007,2020-03-31T17:16:01Z
Barry,1,0,1,29009,2020-03-31T17:16:01Z
Barton,0,0,0,29011,2020-03-31T17:16:01Z
Bates,1,0,1,29013,2020-03-31T17:16:01Z
Benton,1,0,1,29015,2020-03-31T17:16:01Z
Bollinger,1,0,1,29017,2020-03-31T17:16:01Z
Boone,59,4,55,29019,2020-03-31T17:16:01Z
Buchanan,3,0,3,29021,2020-03-31T17:16:01Z
Butler,0,0,0,29023,2020-03-31T17:16:01Z
Caldwell,0,0,0,29025,2020-03-31T17:16:01Z
Callaway,13,1,12,29027,2020-03-31T17:16:01Z
Camden,11,2,9,29029,2020-03-31T17:16:01Z
Cape Girardeau,13,0,13,29031,2020-03-31T17:16:01Z
Carroll,0,0,0,29033,2020-03-31T17:16:01Z
Carter,2,1,1,29035,2020-03-31T17:16:01Z
Cass,9,4,5,29037,2020-03-31T17:16:01Z
Cedar,5,0,5,29039,2020-03-31T17:16:01Z
Chariton,3,0,3,29041,2020-03-31T17:16:01Z
Christian,12,4,8,29043,2020-03-31T17:16:01Z
Clark,0,0,0,29045,2020-03-31T17:16:01Z
Clay,13,0,13,29047,2020-03-31T17:16:01Z
Clinton,4,0,4,29049,2020-03-31T17:16:01Z
Cole,25,3,22,29051,2020-03-31T17:16:01Z
Cooper,1,0,1,29053,2020-03-31T17:16:01Z
Crawford,1,0,1,29055,2020-03-31T17:16:01Z
Dade,0,0,0,29057,2020-03-31T17:16:01Z
Dallas,0,0,0,29059,2020-03-31T17:16:01Z
Daviess,0,0,0,29061,2020-03-31T17:16:01Z
DeKalb,0,0,0,NA,2020-03-31T17:16:01Z
Dent,0,0,0,29065,2020-03-31T17:16:01Z
Douglas,0,0,0,29067,2020-03-31T17:16:01Z
Dunklin,6,0,6,29069,2020-03-31T17:16:01Z
Franklin,7,0,7,29071,2020-03-31T17:16:01Z
Gasconade,0,0,0,29073,2020-03-31T17:16:01Z
Gentry,0,0,0,29075,2020-03-31T17:16:01Z
Greene,38,17,21,29077,2020-03-31T17:16:01Z
Grundy,0,0,0,29079,2020-03-31T17:16:01Z
Harrison,0,0,0,29081,2020-03-31T17:16:01Z
Henry,1,1,0,29083,2020-03-31T17:16:01Z
Hickory,0,0,0,29085,2020-03-31T17:16:01Z
Holt,0,0,0,29087,2020-03-31T17:16:01Z
Howard,0,0,0,29089,2020-03-31T17:16:01Z
Howell,0,0,0,29091,2020-03-31T17:16:01Z
Iron,0,0,0,29093,2020-03-31T17:16:01Z
Jackson,56,4,52,29095,2020-03-31T17:16:01Z
Jasper,3,1,2,29097,2020-03-31T17:16:01Z
Jefferson,18,3,15,29099,2020-03-31T17:16:01Z
Johnson,9,1,8,29101,2020-03-31T17:16:01Z
Joplin,1,0,1,NA,2020-03-31T17:16:01Z
Kansas City,100,2,98,NA,2020-03-31T17:16:01Z
Knox,0,0,0,29103,2020-03-31T17:16:01Z
Laclede,0,0,0,29105,2020-03-31T17:16:01Z
Lafayette,17,0,17,29107,2020-03-31T17:16:01Z
Lawrence,0,0,0,29109,2020-03-31T17:16:01Z
Lewis,0,0,0,29111,2020-03-31T17:16:01Z
Lincoln,5,1,4,29113,2020-03-31T17:16:01Z
Linn,0,0,0,29115,2020-03-31T17:16:01Z
Livingston,1,0,1,29117,2020-03-31T17:16:01Z
Macon,1,0,1,29121,2020-03-31T17:16:01Z
Madison,0,0,0,29123,2020-03-31T17:16:01Z
Maries,1,0,1,29125,2020-03-31T17:16:01Z
Marion,0,0,0,29127,2020-03-31T17:16:01Z
McDonald,2,0,2,NA,2020-03-31T17:16:01Z
Mercer,0,0,0,29129,2020-03-31T17:16:01Z
Miller,0,0,0,29131,2020-03-31T17:16:01Z
Mississippi,0,0,0,29133,2020-03-31T17:16:01Z
Moniteau,2,0,2,29135,2020-03-31T17:16:01Z
Monroe,0,0,0,29137,2020-03-31T17:16:01Z
Montgomery,2,0,2,29139,2020-03-31T17:16:01Z
Morgan,1,0,1,29141,2020-03-31T17:16:01Z
New Madrid,0,0,0,29143,2020-03-31T17:16:01Z
Newton,4,3,1,29145,2020-03-31T17:16:01Z
Nodaway,0,0,0,29147,2020-03-31T17:16:01Z
Oregon,0,0,0,29149,2020-03-31T17:16:01Z
Osage,1,0,1,29151,2020-03-31T17:16:01Z
Ozark,0,0,0,29153,2020-03-31T17:16:01Z
Pemiscot,2,0,2,29155,2020-03-31T17:16:01Z
Perry,12,9,3,29157,2020-03-31T17:16:01Z
Pettis,1,0,1,29159,2020-03-31T17:16:01Z
Phelps,0,0,0,29161,2020-03-31T17:16:01Z
Pike,1,1,0,29163,2020-03-31T17:16:01Z
Platte,7,0,7,29165,2020-03-31T17:16:01Z
Polk,0,0,0,29167,2020-03-31T17:16:01Z
Pulaski,6,1,5,29169,2020-03-31T17:16:01Z
Putnam,0,0,0,29171,2020-03-31T17:16:01Z
Ralls,1,1,0,29173,2020-03-31T17:16:01Z
Randolph,1,0,1,29175,2020-03-31T17:16:01Z
Ray,1,0,1,29177,2020-03-31T17:16:01Z
Reynolds,2,1,1,29179,2020-03-31T17:16:01Z
Ripley,2,0,2,29181,2020-03-31T17:16:01Z
Saline,0,0,0,29195,2020-03-31T17:16:01Z
Schuyler,0,0,0,29197,2020-03-31T17:16:01Z
Scotland,0,0,0,29199,2020-03-31T17:16:01Z
Scott,5,1,4,29201,2020-03-31T17:16:01Z
Shannon,0,0,0,29203,2020-03-31T17:16:01Z
Shelby,1,1,0,29205,2020-03-31T17:16:01Z
St. Charles,56,11,45,29183,2020-03-31T17:16:01Z
St. Clair,0,0,0,29185,2020-03-31T17:16:01Z
St. Francois,3,1,2,29187,2020-03-31T17:16:01Z
St. Louis City,91,11,80,29510,2020-03-31T17:16:01Z
St. Louis,366,29,337,29189,2020-03-31T17:16:01Z
Ste. Genevieve,0,0,0,29186,2020-03-31T17:16:01Z
Stoddard,2,0,2,29207,2020-03-31T17:16:01Z
Stone,1,1,0,29209,2020-03-31T17:16:01Z
Sullivan,0,0,0,29211,2020-03-31T17:16:01Z
Taney,2,0,2,29213,2020-03-31T17:16:01Z
Texas,1,0,1,29215,2020-03-31T17:16:01Z
Vernon,0,0,0,29217,2020-03-31T17:16:01Z
Warren,2,0,2,29219,2020-03-31T17:16:01Z
Washington,0,0,0,29221,2020-03-31T17:16:01Z
Wayne,0,0,0,29223,2020-03-31T17:16:01Z
Webster,1,0,1,29225,2020-03-31T17:16:01Z
Worth,0,0,0,29227,2020-03-31T17:16:01Z
Wright,4,1,3,29229,2020-03-31T17:16:01Z
TBD,12,2,10,NA,2020-03-31T17:16:01Z
Adair,1,0,1,29001,2020-03-31T13:16:01Z
Andrew,0,0,0,29003,2020-03-31T13:16:01Z
Atchison,1,1,0,29005,2020-03-31T13:16:01Z
Audrain,0,0,0,29007,2020-03-31T13:16:01Z
Barry,1,0,1,29009,2020-03-31T13:16:01Z
Barton,0,0,0,29011,2020-03-31T13:16:01Z
Bates,1,0,1,29013,2020-03-31T13:16:01Z
Benton,1,0,1,29015,2020-03-31T13:16:01Z
Bollinger,1,0,1,29017,2020-03-31T13:16:01Z
Boone,59,4,55,29019,2020-03-31T13:16:01Z
Buchanan,3,0,3,29021,2020-03-31T13:16:01Z
Butler,0,0,0,29023,2020-03-31T13:16:01Z
Caldwell,0,0,0,29025,2020-03-31T13:16:01Z
Callaway,13,1,12,29027,2020-03-31T13:16:01Z
Camden,11,2,9,29029,2020-03-31T13:16:01Z
Cape Girardeau,13,0,13,29031,2020-03-31T13:16:01Z
Carroll,0,0,0,29033,2020-03-31T13:16:01Z
Carter,2,1,1,29035,2020-03-31T13:16:01Z
Cass,9,4,5,29037,2020-03-31T13:16:01Z
Cedar,5,0,5,29039,2020-03-31T13:16:01Z
Chariton,3,0,3,29041,2020-03-31T13:16:01Z
Christian,12,4,8,29043,2020-03-31T13:16:01Z
Clark,0,0,0,29045,2020-03-31T13:16:01Z
Clay,13,0,13,29047,2020-03-31T13:16:01Z
Clinton,4,0,4,29049,2020-03-31T13:16:01Z
Cole,25,3,22,29051,2020-03-31T13:16:01Z
Cooper,1,0,1,29053,2020-03-31T13:16:01Z
Crawford,1,0,1,29055,2020-03-31T13:16:01Z
Dade,0,0,0,29057,2020-03-31T13:16:01Z
Dallas,0,0,0,29059,2020-03-31T13:16:01Z
Daviess,0,0,0,29061,2020-03-31T13:16:01Z
DeKalb,0,0,0,NA,2020-03-31T13:16:01Z
Dent,0,0,0,29065,2020-03-31T13:16:01Z
Douglas,0,0,0,29067,2020-03-31T13:16:01Z
Dunklin,6,0,6,29069,2020-03-31T13:16:01Z
Franklin,7,0,7,29071,2020-03-31T13:16:01Z
Gasconade,0,0,0,29073,2020-03-31T13:16:01Z
Gentry,0,0,0,29075,2020-03-31T13:16:01Z
Greene,38,17,21,29077,2020-03-31T13:16:01Z
Grundy,0,0,0,29079,2020-03-31T13:16:01Z
Harrison,0,0,0,29081,2020-03-31T13:16:01Z
Henry,1,1,0,29083,2020-03-31T13:16:01Z
Hickory,0,0,0,29085,2020-03-31T13:16:01Z
Holt,0,0,0,29087,2020-03-31T13:16:01Z
Howard,0,0,0,29089,2020-03-31T13:16:01Z
Howell,0,0,0,29091,2020-03-31T13:16:01Z
Iron,0,0,0,29093,2020-03-31T13:16:01Z
Jackson,56,4,52,29095,2020-03-31T13:16:01Z
Jasper,3,1,2,29097,2020-03-31T13:16:01Z
Jefferson,18,3,15,29099,2020-03-31T13:16:01Z
Johnson,9,1,8,29101,2020-03-31T13:16:01Z
Joplin,1,0,1,NA,2020-03-31T13:16:01Z
Kansas City,100,2,98,NA,2020-03-31T13:16:01Z
Knox,0,0,0,29103,2020-03-31T13:16:01Z
Laclede,0,0,0,29105,2020-03-31T13:16:01Z
Lafayette,17,0,17,29107,2020-03-31T13:16:01Z
Lawrence,0,0,0,29109,2020-03-31T13:16:01Z
Lewis,0,0,0,29111,2020-03-31T13:16:01Z
Lincoln,5,1,4,29113,2020-03-31T13:16:01Z
Linn,0,0,0,29115,2020-03-31T13:16:01Z
Livingston,1,0,1,29117,2020-03-31T13:16:01Z
Macon,1,0,1,29121,2020-03-31T13:16:01Z
Madison,0,0,0,29123,2020-03-31T13:16:01Z
Maries,1,0,1,29125,2020-03-31T13:16:01Z
Marion,0,0,0,29127,2020-03-31T13:16:01Z
McDonald,2,0,2,NA,2020-03-31T13:16:01Z
Mercer,0,0,0,29129,2020-03-31T13:16:01Z
Miller,0,0,0,29131,2020-03-31T13:16:01Z
Mississippi,0,0,0,29133,2020-03-31T13:16:01Z
Moniteau,2,0,2,29135,2020-03-31T13:16:01Z
Monroe,0,0,0,29137,2020-03-31T13:16:01Z
Montgomery,2,0,2,29139,2020-03-31T13:16:01Z
Morgan,1,0,1,29141,2020-03-31T13:16:01Z
New Madrid,0,0,0,29143,2020-03-31T13:16:01Z
Newton,4,3,1,29145,2020-03-31T13:16:01Z
Nodaway,0,0,0,29147,2020-03-31T13:16:01Z
Oregon,0,0,0,29149,2020-03-31T13:16:01Z
Osage,1,0,1,29151,2020-03-31T13:16:01Z
Ozark,0,0,0,29153,2020-03-31T13:16:01Z
Pemiscot,2,0,2,29155,2020-03-31T13:16:01Z
Perry,12,9,3,29157,2020-03-31T13:16:01Z
Pettis,1,0,1,29159,2020-03-31T13:16:01Z
Phelps,0,0,0,29161,2020-03-31T13:16:01Z
Pike,1,1,0,29163,2020-03-31T13:16:01Z
Platte,7,0,7,29165,2020-03-31T13:16:01Z
Polk,0,0,0,29167,2020-03-31T13:16:01Z
Pulaski,6,1,5,29169,2020-03-31T13:16:01Z
Putnam,0,0,0,29171,2020-03-31T13:16:01Z
Ralls,1,1,0,29173,2020-03-31T13:16:01Z
Randolph,1,0,1,29175,2020-03-31T13:16:01Z
Ray,1,0,1,29177,2020-03-31T13:16:01Z
Reynolds,2,1,1,29179,2020-03-31T13:16:01Z
Ripley,2,0,2,29181,2020-03-31T13:16:01Z
Saline,0,0,0,29195,2020-03-31T13:16:01Z
Schuyler,0,0,0,29197,2020-03-31T13:16:01Z
Scotland,0,0,0,29199,2020-03-31T13:16:01Z
Scott,5,1,4,29201,2020-03-31T13:16:01Z
Shannon,0,0,0,29203,2020-03-31T13:16:01Z
Shelby,1,1,0,29205,2020-03-31T13:16:01Z
St. Charles,56,11,45,29183,2020-03-31T13:16:01Z
St. Clair,0,0,0,29185,2020-03-31T13:16:01Z
St. Francois,3,1,2,29187,2020-03-31T13:16:01Z
St. Louis City,91,11,80,29510,2020-03-31T13:16:01Z
St. Louis,366,29,337,29189,2020-03-31T13:16:01Z
Ste. Genevieve,0,0,0,29186,2020-03-31T13:16:01Z
Stoddard,2,0,2,29207,2020-03-31T13:16:01Z
Stone,1,1,0,29209,2020-03-31T13:16:01Z
Sullivan,0,0,0,29211,2020-03-31T13:16:01Z
Taney,2,0,2,29213,2020-03-31T13:16:01Z
Texas,1,0,1,29215,2020-03-31T13:16:01Z
Vernon,0,0,0,29217,2020-03-31T13:16:01Z
Warren,2,0,2,29219,2020-03-31T13:16:01Z
Washington,0,0,0,29221,2020-03-31T13:16:01Z
Wayne,0,0,0,29223,2020-03-31T13:16:01Z
Webster,1,0,1,29225,2020-03-31T13:16:01Z
Worth,0,0,0,29227,2020-03-31T13:16:01Z
Wright,4,1,3,29229,2020-03-31T13:16:01Z
TBD,12,2,10,NA,2020-03-31T13:16:01Z
Adair,1,0,1,29001,2020-03-31T01:16:02Z
Andrew,0,0,0,29003,2020-03-31T01:16:02Z
Atchison,1,1,0,29005,2020-03-31T01:16:02Z
Audrain,0,0,0,29007,2020-03-31T01:16:02Z
Barry,1,0,1,29009,2020-03-31T01:16:02Z
Barton,0,0,0,29011,2020-03-31T01:16:02Z
Bates,1,0,1,29013,2020-03-31T01:16:02Z
Benton,1,0,1,29015,2020-03-31T01:16:02Z
Bollinger,1,0,1,29017,2020-03-31T01:16:02Z
Boone,59,4,55,29019,2020-03-31T01:16:02Z
Buchanan,3,0,3,29021,2020-03-31T01:16:02Z
Butler,0,0,0,29023,2020-03-31T01:16:02Z
Caldwell,0,0,0,29025,2020-03-31T01:16:02Z
Callaway,13,1,12,29027,2020-03-31T01:16:02Z
Camden,11,2,9,29029,2020-03-31T01:16:02Z
Cape Girardeau,13,0,13,29031,2020-03-31T01:16:02Z
Carroll,0,0,0,29033,2020-03-31T01:16:02Z
Carter,2,1,1,29035,2020-03-31T01:16:02Z
Cass,9,4,5,29037,2020-03-31T01:16:02Z
Cedar,5,0,5,29039,2020-03-31T01:16:02Z
Chariton,3,0,3,29041,2020-03-31T01:16:02Z
Christian,12,4,8,29043,2020-03-31T01:16:02Z
Clark,0,0,0,29045,2020-03-31T01:16:02Z
Clay,13,0,13,29047,2020-03-31T01:16:02Z
Clinton,4,0,4,29049,2020-03-31T01:16:02Z
Cole,25,3,22,29051,2020-03-31T01:16:02Z
Cooper,1,0,1,29053,2020-03-31T01:16:02Z
Crawford,1,0,1,29055,2020-03-31T01:16:02Z
Dade,0,0,0,29057,2020-03-31T01:16:02Z
Dallas,0,0,0,29059,2020-03-31T01:16:02Z
Daviess,0,0,0,29061,2020-03-31T01:16:02Z
DeKalb,0,0,0,NA,2020-03-31T01:16:02Z
Dent,0,0,0,29065,2020-03-31T01:16:02Z
Douglas,0,0,0,29067,2020-03-31T01:16:02Z
Dunklin,6,0,6,29069,2020-03-31T01:16:02Z
Franklin,7,0,7,29071,2020-03-31T01:16:02Z
Gasconade,0,0,0,29073,2020-03-31T01:16:02Z
Gentry,0,0,0,29075,2020-03-31T01:16:02Z
Greene,38,17,21,29077,2020-03-31T01:16:02Z
Grundy,0,0,0,29079,2020-03-31T01:16:02Z
Harrison,0,0,0,29081,2020-03-31T01:16:02Z
Henry,1,1,0,29083,2020-03-31T01:16:02Z
Hickory,0,0,0,29085,2020-03-31T01:16:02Z
Holt,0,0,0,29087,2020-03-31T01:16:02Z
Howard,0,0,0,29089,2020-03-31T01:16:02Z
Howell,0,0,0,29091,2020-03-31T01:16:02Z
Iron,0,0,0,29093,2020-03-31T01:16:02Z
Jackson,56,4,52,29095,2020-03-31T01:16:02Z
Jasper,3,1,2,29097,2020-03-31T01:16:02Z
Jefferson,18,3,15,29099,2020-03-31T01:16:02Z
Johnson,9,1,8,29101,2020-03-31T01:16:02Z
Joplin,1,0,1,NA,2020-03-31T01:16:02Z
Kansas City,100,2,98,NA,2020-03-31T01:16:02Z
Knox,0,0,0,29103,2020-03-31T01:16:02Z
Laclede,0,0,0,29105,2020-03-31T01:16:02Z
Lafayette,17,0,17,29107,2020-03-31T01:16:02Z
Lawrence,0,0,0,29109,2020-03-31T01:16:02Z
Lewis,0,0,0,29111,2020-03-31T01:16:02Z
Lincoln,5,1,4,29113,2020-03-31T01:16:02Z
Linn,0,0,0,29115,2020-03-31T01:16:02Z
Livingston,1,0,1,29117,2020-03-31T01:16:02Z
Macon,1,0,1,29121,2020-03-31T01:16:02Z
Madison,0,0,0,29123,2020-03-31T01:16:02Z
Maries,1,0,1,29125,2020-03-31T01:16:02Z
Marion,0,0,0,29127,2020-03-31T01:16:02Z
McDonald,2,0,2,NA,2020-03-31T01:16:02Z
Mercer,0,0,0,29129,2020-03-31T01:16:02Z
Miller,0,0,0,29131,2020-03-31T01:16:02Z
Mississippi,0,0,0,29133,2020-03-31T01:16:02Z
Moniteau,2,0,2,29135,2020-03-31T01:16:02Z
Monroe,0,0,0,29137,2020-03-31T01:16:02Z
Montgomery,2,0,2,29139,2020-03-31T01:16:02Z
Morgan,1,0,1,29141,2020-03-31T01:16:02Z
New Madrid,0,0,0,29143,2020-03-31T01:16:02Z
Newton,4,3,1,29145,2020-03-31T01:16:02Z
Nodaway,0,0,0,29147,2020-03-31T01:16:02Z
Oregon,0,0,0,29149,2020-03-31T01:16:02Z
Osage,1,0,1,29151,2020-03-31T01:16:02Z
Ozark,0,0,0,29153,2020-03-31T01:16:02Z
Pemiscot,2,0,2,29155,2020-03-31T01:16:02Z
Perry,12,9,3,29157,2020-03-31T01:16:02Z
Pettis,1,0,1,29159,2020-03-31T01:16:02Z
Phelps,0,0,0,29161,2020-03-31T01:16:02Z
Pike,1,1,0,29163,2020-03-31T01:16:02Z
Platte,7,0,7,29165,2020-03-31T01:16:02Z
Polk,0,0,0,29167,2020-03-31T01:16:02Z
Pulaski,6,1,5,29169,2020-03-31T01:16:02Z
Putnam,0,0,0,29171,2020-03-31T01:16:02Z
Ralls,1,1,0,29173,2020-03-31T01:16:02Z
Randolph,1,0,1,29175,2020-03-31T01:16:02Z
Ray,1,0,1,29177,2020-03-31T01:16:02Z
Reynolds,2,1,1,29179,2020-03-31T01:16:02Z
Ripley,2,0,2,29181,2020-03-31T01:16:02Z
Saline,0,0,0,29195,2020-03-31T01:16:02Z
Schuyler,0,0,0,29197,2020-03-31T01:16:02Z
Scotland,0,0,0,29199,2020-03-31T01:16:02Z
Scott,5,1,4,29201,2020-03-31T01:16:02Z
Shannon,0,0,0,29203,2020-03-31T01:16:02Z
Shelby,1,1,0,29205,2020-03-31T01:16:02Z
St. Charles,56,11,45,29183,2020-03-31T01:16:02Z
St. Clair,0,0,0,29185,2020-03-31T01:16:02Z
St. Francois,3,1,2,29187,2020-03-31T01:16:02Z
St. Louis City,91,11,80,29510,2020-03-31T01:16:02Z
St. Louis,366,29,337,29189,2020-03-31T01:16:02Z
Ste. Genevieve,0,0,0,29186,2020-03-31T01:16:02Z
Stoddard,2,0,2,29207,2020-03-31T01:16:02Z
Stone,1,1,0,29209,2020-03-31T01:16:02Z
Sullivan,0,0,0,29211,2020-03-31T01:16:02Z
Taney,2,0,2,29213,2020-03-31T01:16:02Z
Texas,1,0,1,29215,2020-03-31T01:16:02Z
Vernon,0,0,0,29217,2020-03-31T01:16:02Z
Warren,2,0,2,29219,2020-03-31T01:16:02Z
Washington,0,0,0,29221,2020-03-31T01:16:02Z
Wayne,0,0,0,29223,2020-03-31T01:16:02Z
Webster,1,0,1,29225,2020-03-31T01:16:02Z
Worth,0,0,0,29227,2020-03-31T01:16:02Z
Wright,4,1,3,29229,2020-03-31T01:16:02Z
TBD,12,2,10,NA,2020-03-31T01:16:02Z
Adair,1,0,1,29001,2020-03-30T21:16:01Z
Andrew,0,0,0,29003,2020-03-30T21:16:01Z
Atchison,1,1,0,29005,2020-03-30T21:16:01Z
Audrain,0,0,0,29007,2020-03-30T21:16:01Z
Barry,1,0,1,29009,2020-03-30T21:16:01Z
Barton,0,0,0,29011,2020-03-30T21:16:01Z
Bates,1,0,1,29013,2020-03-30T21:16:01Z
Benton,1,0,1,29015,2020-03-30T21:16:01Z
Bollinger,1,0,1,29017,2020-03-30T21:16:01Z
Boone,59,4,55,29019,2020-03-30T21:16:01Z
Buchanan,3,0,3,29021,2020-03-30T21:16:01Z
Butler,0,0,0,29023,2020-03-30T21:16:01Z
Caldwell,0,0,0,29025,2020-03-30T21:16:01Z
Callaway,13,1,12,29027,2020-03-30T21:16:01Z
Camden,11,2,9,29029,2020-03-30T21:16:01Z
Cape Girardeau,13,0,13,29031,2020-03-30T21:16:01Z
Carroll,0,0,0,29033,2020-03-30T21:16:01Z
Carter,2,1,1,29035,2020-03-30T21:16:01Z
Cass,9,4,5,29037,2020-03-30T21:16:01Z
Cedar,5,0,5,29039,2020-03-30T21:16:01Z
Chariton,3,0,3,29041,2020-03-30T21:16:01Z
Christian,12,4,8,29043,2020-03-30T21:16:01Z
Clark,0,0,0,29045,2020-03-30T21:16:01Z
Clay,13,0,13,29047,2020-03-30T21:16:01Z
Clinton,4,0,4,29049,2020-03-30T21:16:01Z
Cole,25,3,22,29051,2020-03-30T21:16:01Z
Cooper,1,0,1,29053,2020-03-30T21:16:01Z
Crawford,1,0,1,29055,2020-03-30T21:16:01Z
Dade,0,0,0,29057,2020-03-30T21:16:01Z
Dallas,0,0,0,29059,2020-03-30T21:16:01Z
Daviess,0,0,0,29061,2020-03-30T21:16:01Z
DeKalb,0,0,0,NA,2020-03-30T21:16:01Z
Dent,0,0,0,29065,2020-03-30T21:16:01Z
Douglas,0,0,0,29067,2020-03-30T21:16:01Z
Dunklin,6,0,6,29069,2020-03-30T21:16:01Z
Franklin,7,0,7,29071,2020-03-30T21:16:01Z
Gasconade,0,0,0,29073,2020-03-30T21:16:01Z
Gentry,0,0,0,29075,2020-03-30T21:16:01Z
Greene,38,17,21,29077,2020-03-30T21:16:01Z
Grundy,0,0,0,29079,2020-03-30T21:16:01Z
Harrison,0,0,0,29081,2020-03-30T21:16:01Z
Henry,1,1,0,29083,2020-03-30T21:16:01Z
Hickory,0,0,0,29085,2020-03-30T21:16:01Z
Holt,0,0,0,29087,2020-03-30T21:16:01Z
Howard,0,0,0,29089,2020-03-30T21:16:01Z
Howell,0,0,0,29091,2020-03-30T21:16:01Z
Iron,0,0,0,29093,2020-03-30T21:16:01Z
Jackson,56,4,52,29095,2020-03-30T21:16:01Z
Jasper,3,1,2,29097,2020-03-30T21:16:01Z
Jefferson,18,3,15,29099,2020-03-30T21:16:01Z
Johnson,9,1,8,29101,2020-03-30T21:16:01Z
Joplin,1,0,1,NA,2020-03-30T21:16:01Z
Kansas City,100,2,98,NA,2020-03-30T21:16:01Z
Knox,0,0,0,29103,2020-03-30T21:16:01Z
Laclede,0,0,0,29105,2020-03-30T21:16:01Z
Lafayette,17,0,17,29107,2020-03-30T21:16:01Z
Lawrence,0,0,0,29109,2020-03-30T21:16:01Z
Lewis,0,0,0,29111,2020-03-30T21:16:01Z
Lincoln,5,1,4,29113,2020-03-30T21:16:01Z
Linn,0,0,0,29115,2020-03-30T21:16:01Z
Livingston,1,0,1,29117,2020-03-30T21:16:01Z
Macon,1,0,1,29121,2020-03-30T21:16:01Z
Madison,0,0,0,29123,2020-03-30T21:16:01Z
Maries,1,0,1,29125,2020-03-30T21:16:01Z
Marion,0,0,0,29127,2020-03-30T21:16:01Z
McDonald,2,0,2,NA,2020-03-30T21:16:01Z
Mercer,0,0,0,29129,2020-03-30T21:16:01Z
Miller,0,0,0,29131,2020-03-30T21:16:01Z
Mississippi,0,0,0,29133,2020-03-30T21:16:01Z
Moniteau,2,0,2,29135,2020-03-30T21:16:01Z
Monroe,0,0,0,29137,2020-03-30T21:16:01Z
Montgomery,2,0,2,29139,2020-03-30T21:16:01Z
Morgan,1,0,1,29141,2020-03-30T21:16:01Z
New Madrid,0,0,0,29143,2020-03-30T21:16:01Z
Newton,4,3,1,29145,2020-03-30T21:16:01Z
Nodaway,0,0,0,29147,2020-03-30T21:16:01Z
Oregon,0,0,0,29149,2020-03-30T21:16:01Z
Osage,1,0,1,29151,2020-03-30T21:16:01Z
Ozark,0,0,0,29153,2020-03-30T21:16:01Z
Pemiscot,2,0,2,29155,2020-03-30T21:16:01Z
Perry,12,9,3,29157,2020-03-30T21:16:01Z
Pettis,1,0,1,29159,2020-03-30T21:16:01Z
Phelps,0,0,0,29161,2020-03-30T21:16:01Z
Pike,1,1,0,29163,2020-03-30T21:16:01Z
Platte,7,0,7,29165,2020-03-30T21:16:01Z
Polk,0,0,0,29167,2020-03-30T21:16:01Z
Pulaski,6,1,5,29169,2020-03-30T21:16:01Z
Putnam,0,0,0,29171,2020-03-30T21:16:01Z
Ralls,1,1,0,29173,2020-03-30T21:16:01Z
Randolph,1,0,1,29175,2020-03-30T21:16:01Z
Ray,1,0,1,29177,2020-03-30T21:16:01Z
Reynolds,2,1,1,29179,2020-03-30T21:16:01Z
Ripley,2,0,2,29181,2020-03-30T21:16:01Z
Saline,0,0,0,29195,2020-03-30T21:16:01Z
Schuyler,0,0,0,29197,2020-03-30T21:16:01Z
Scotland,0,0,0,29199,2020-03-30T21:16:01Z
Scott,5,1,4,29201,2020-03-30T21:16:01Z
Shannon,0,0,0,29203,2020-03-30T21:16:01Z
Shelby,1,1,0,29205,2020-03-30T21:16:01Z
St. Charles,56,11,45,29183,2020-03-30T21:16:01Z
St. Clair,0,0,0,29185,2020-03-30T21:16:01Z
St. Francois,3,1,2,29187,2020-03-30T21:16:01Z
St. Louis City,91,11,80,29510,2020-03-30T21:16:01Z
St. Louis,366,29,337,29189,2020-03-30T21:16:01Z
Ste. Genevieve,0,0,0,29186,2020-03-30T21:16:01Z
Stoddard,2,0,2,29207,2020-03-30T21:16:01Z
Stone,1,1,0,29209,2020-03-30T21:16:01Z
Sullivan,0,0,0,29211,2020-03-30T21:16:01Z
Taney,2,0,2,29213,2020-03-30T21:16:01Z
Texas,1,0,1,29215,2020-03-30T21:16:01Z
Vernon,0,0,0,29217,2020-03-30T21:16:01Z
Warren,2,0,2,29219,2020-03-30T21:16:01Z
Washington,0,0,0,29221,2020-03-30T21:16:01Z
Wayne,0,0,0,29223,2020-03-30T21:16:01Z
Webster,1,0,1,29225,2020-03-30T21:16:01Z
Worth,0,0,0,29227,2020-03-30T21:16:01Z
Wright,4,1,3,29229,2020-03-30T21:16:01Z
TBD,12,2,10,NA,2020-03-30T21:16:01Z
Adair,1,0,1,29001,2020-03-30T17:16:02Z
Andrew,0,0,0,29003,2020-03-30T17:16:02Z
Atchison,1,1,0,29005,2020-03-30T17:16:02Z
Audrain,0,0,0,29007,2020-03-30T17:16:02Z
Barry,1,0,1,29009,2020-03-30T17:16:02Z
Barton,0,0,0,29011,2020-03-30T17:16:02Z
Bates,2,0,2,29013,2020-03-30T17:16:02Z
Benton,1,0,1,29015,2020-03-30T17:16:02Z
Bollinger,1,0,1,29017,2020-03-30T17:16:02Z
Boone,50,6,44,29019,2020-03-30T17:16:02Z
Buchanan,3,0,3,29021,2020-03-30T17:16:02Z
Butler,0,0,0,29023,2020-03-30T17:16:02Z
Caldwell,0,0,0,29025,2020-03-30T17:16:02Z
Callaway,8,1,7,29027,2020-03-30T17:16:02Z
Camden,7,1,6,29029,2020-03-30T17:16:02Z
Cape Girardeau,5,0,5,29031,2020-03-30T17:16:02Z
Carroll,0,0,0,29033,2020-03-30T17:16:02Z
Carter,2,1,1,29035,2020-03-30T17:16:02Z
Cass,8,2,6,29037,2020-03-30T17:16:02Z
Cedar,0,0,0,29039,2020-03-30T17:16:02Z
Chariton,1,0,1,29041,2020-03-30T17:16:02Z
Christian,7,3,4,29043,2020-03-30T17:16:02Z
Clark,0,0,0,29045,2020-03-30T17:16:02Z
Clay,11,0,11,29047,2020-03-30T17:16:02Z
Clinton,1,1,0,29049,2020-03-30T17:16:02Z
Cole,17,0,17,29051,2020-03-30T17:16:02Z
Cooper,1,0,1,29053,2020-03-30T17:16:02Z
Crawford,0,0,0,29055,2020-03-30T17:16:02Z
Dade,0,0,0,29057,2020-03-30T17:16:02Z
Dallas,0,0,0,29059,2020-03-30T17:16:02Z
Daviess,0,0,0,29061,2020-03-30T17:16:02Z
DeKalb,0,0,0,NA,2020-03-30T17:16:02Z
Dent,0,0,0,29065,2020-03-30T17:16:02Z
Douglas,0,0,0,29067,2020-03-30T17:16:02Z
Dunklin,3,0,3,29069,2020-03-30T17:16:02Z
Franklin,7,2,5,29071,2020-03-30T17:16:02Z
Gasconade,0,0,0,29073,2020-03-30T17:16:02Z
Gentry,0,0,0,29075,2020-03-30T17:16:02Z
Greene,41,9,32,29077,2020-03-30T17:16:02Z
Grundy,0,0,0,29079,2020-03-30T17:16:02Z
Harrison,0,0,0,29081,2020-03-30T17:16:02Z
Henry,1,0,1,29083,2020-03-30T17:16:02Z
Hickory,0,0,0,29085,2020-03-30T17:16:02Z
Holt,0,0,0,29087,2020-03-30T17:16:02Z
Howard,0,0,0,29089,2020-03-30T17:16:02Z
Howell,0,0,0,29091,2020-03-30T17:16:02Z
Iron,0,0,0,29093,2020-03-30T17:16:02Z
Jackson,48,3,45,29095,2020-03-30T17:16:02Z
Jasper,1,0,1,29097,2020-03-30T17:16:02Z
Jefferson,17,2,15,29099,2020-03-30T17:16:02Z
Johnson,9,1,8,29101,2020-03-30T17:16:02Z
Joplin,1,0,1,NA,2020-03-30T17:16:02Z
Kansas City,102,9,93,NA,2020-03-30T17:16:02Z
Knox,0,0,0,29103,2020-03-30T17:16:02Z
Laclede,0,0,0,29105,2020-03-30T17:16:02Z
Lafayette,4,0,4,29107,2020-03-30T17:16:02Z
Lawrence,0,0,0,29109,2020-03-30T17:16:02Z
Lewis,0,0,0,29111,2020-03-30T17:16:02Z
Lincoln,2,1,1,29113,2020-03-30T17:16:02Z
Linn,0,0,0,29115,2020-03-30T17:16:02Z
Livingston,0,0,0,29117,2020-03-30T17:16:02Z
Macon,0,0,0,29121,2020-03-30T17:16:02Z
Madison,0,0,0,29123,2020-03-30T17:16:02Z
Maries,0,0,0,29125,2020-03-30T17:16:02Z
Marion,0,0,0,29127,2020-03-30T17:16:02Z
McDonald,1,0,1,NA,2020-03-30T17:16:02Z
Mercer,0,0,0,29129,2020-03-30T17:16:02Z
Miller,0,0,0,29131,2020-03-30T17:16:02Z
Mississippi,0,0,0,29133,2020-03-30T17:16:02Z
Moniteau,4,0,4,29135,2020-03-30T17:16:02Z
Monroe,0,0,0,29137,2020-03-30T17:16:02Z
Montgomery,3,0,3,29139,2020-03-30T17:16:02Z
Morgan,0,0,0,29141,2020-03-30T17:16:02Z
New Madrid,0,0,0,29143,2020-03-30T17:16:02Z
Newton,4,3,1,29145,2020-03-30T17:16:02Z
Nodaway,0,0,0,29147,2020-03-30T17:16:02Z
Oregon,0,0,0,29149,2020-03-30T17:16:02Z
Osage,0,0,0,29151,2020-03-30T17:16:02Z
Ozark,0,0,0,29153,2020-03-30T17:16:02Z
Pemiscot,1,0,1,29155,2020-03-30T17:16:02Z
Perry,7,4,3,29157,2020-03-30T17:16:02Z
Pettis,1,0,1,29159,2020-03-30T17:16:02Z
Phelps,0,0,0,29161,2020-03-30T17:16:02Z
Pike,0,0,0,29163,2020-03-30T17:16:02Z
Platte,6,1,5,29165,2020-03-30T17:16:02Z
Polk,0,0,0,29167,2020-03-30T17:16:02Z
Pulaski,5,1,4,29169,2020-03-30T17:16:02Z
Putnam,0,0,0,29171,2020-03-30T17:16:02Z
Ralls,1,1,0,29173,2020-03-30T17:16:02Z
Randolph,1,0,1,29175,2020-03-30T17:16:02Z
Ray,1,0,1,29177,2020-03-30T17:16:02Z
Reynolds,0,0,0,29179,2020-03-30T17:16:02Z
Ripley,2,0,2,29181,2020-03-30T17:16:02Z
Saline,0,0,0,29195,2020-03-30T17:16:02Z
Schuyler,0,0,0,29197,2020-03-30T17:16:02Z
Scotland,0,0,0,29199,2020-03-30T17:16:02Z
Scott,3,1,2,29201,2020-03-30T17:16:02Z
Shannon,0,0,0,29203,2020-03-30T17:16:02Z
Shelby,1,1,0,29205,2020-03-30T17:16:02Z
St. Charles,43,6,37,29183,2020-03-30T17:16:02Z
St. Clair,0,0,0,29185,2020-03-30T17:16:02Z
St. Francois,4,0,4,29187,2020-03-30T17:16:02Z
St. Louis City,97,3,94,29510,2020-03-30T17:16:02Z
St. Louis,336,25,311,29189,2020-03-30T17:16:02Z
Ste. Genevieve,0,0,0,29186,2020-03-30T17:16:02Z
Stoddard,2,0,2,29207,2020-03-30T17:16:02Z
Stone,0,0,0,29209,2020-03-30T17:16:02Z
Sullivan,0,0,0,29211,2020-03-30T17:16:02Z
Taney,2,0,2,29213,2020-03-30T17:16:02Z
Texas,1,0,1,29215,2020-03-30T17:16:02Z
Vernon,0,0,0,29217,2020-03-30T17:16:02Z
Warren,2,0,2,29219,2020-03-30T17:16:02Z
Washington,0,0,0,29221,2020-03-30T17:16:02Z
Wayne,0,0,0,29223,2020-03-30T17:16:02Z
Webster,0,0,0,29225,2020-03-30T17:16:02Z
Worth,0,0,0,29227,2020-03-30T17:16:02Z
Wright,3,1,2,29229,2020-03-30T17:16:02Z
TBD,8,2,6,NA,2020-03-30T17:16:02Z
Adair,1,0,1,29001,2020-03-30T13:16:01Z
Andrew,0,0,0,29003,2020-03-30T13:16:01Z
Atchison,1,1,0,29005,2020-03-30T13:16:01Z
Audrain,0,0,0,29007,2020-03-30T13:16:01Z
Barry,1,0,1,29009,2020-03-30T13:16:01Z
Barton,0,0,0,29011,2020-03-30T13:16:01Z
Bates,2,0,2,29013,2020-03-30T13:16:01Z
Benton,1,0,1,29015,2020-03-30T13:16:01Z
Bollinger,1,0,1,29017,2020-03-30T13:16:01Z
Boone,50,6,44,29019,2020-03-30T13:16:01Z
Buchanan,3,0,3,29021,2020-03-30T13:16:01Z
Butler,0,0,0,29023,2020-03-30T13:16:01Z
Caldwell,0,0,0,29025,2020-03-30T13:16:01Z
Callaway,8,1,7,29027,2020-03-30T13:16:01Z
Camden,7,1,6,29029,2020-03-30T13:16:01Z
Cape Girardeau,5,0,5,29031,2020-03-30T13:16:01Z
Carroll,0,0,0,29033,2020-03-30T13:16:01Z
Carter,2,1,1,29035,2020-03-30T13:16:01Z
Cass,8,2,6,29037,2020-03-30T13:16:01Z
Cedar,0,0,0,29039,2020-03-30T13:16:01Z
Chariton,1,0,1,29041,2020-03-30T13:16:01Z
Christian,7,3,4,29043,2020-03-30T13:16:01Z
Clark,0,0,0,29045,2020-03-30T13:16:01Z
Clay,11,0,11,29047,2020-03-30T13:16:01Z
Clinton,1,1,0,29049,2020-03-30T13:16:01Z
Cole,17,0,17,29051,2020-03-30T13:16:01Z
Cooper,1,0,1,29053,2020-03-30T13:16:01Z
Crawford,0,0,0,29055,2020-03-30T13:16:01Z
Dade,0,0,0,29057,2020-03-30T13:16:01Z
Dallas,0,0,0,29059,2020-03-30T13:16:01Z
Daviess,0,0,0,29061,2020-03-30T13:16:01Z
DeKalb,0,0,0,NA,2020-03-30T13:16:01Z
Dent,0,0,0,29065,2020-03-30T13:16:01Z
Douglas,0,0,0,29067,2020-03-30T13:16:01Z
Dunklin,3,0,3,29069,2020-03-30T13:16:01Z
Franklin,7,2,5,29071,2020-03-30T13:16:01Z
Gasconade,0,0,0,29073,2020-03-30T13:16:01Z
Gentry,0,0,0,29075,2020-03-30T13:16:01Z
Greene,41,9,32,29077,2020-03-30T13:16:01Z
Grundy,0,0,0,29079,2020-03-30T13:16:01Z
Harrison,0,0,0,29081,2020-03-30T13:16:01Z
Henry,1,0,1,29083,2020-03-30T13:16:01Z
Hickory,0,0,0,29085,2020-03-30T13:16:01Z
Holt,0,0,0,29087,2020-03-30T13:16:01Z
Howard,0,0,0,29089,2020-03-30T13:16:01Z
Howell,0,0,0,29091,2020-03-30T13:16:01Z
Iron,0,0,0,29093,2020-03-30T13:16:01Z
Jackson,48,3,45,29095,2020-03-30T13:16:01Z
Jasper,1,0,1,29097,2020-03-30T13:16:01Z
Jefferson,17,2,15,29099,2020-03-30T13:16:01Z
Johnson,9,1,8,29101,2020-03-30T13:16:01Z
Joplin,1,0,1,NA,2020-03-30T13:16:01Z
Kansas City,102,9,93,NA,2020-03-30T13:16:01Z
Knox,0,0,0,29103,2020-03-30T13:16:01Z
Laclede,0,0,0,29105,2020-03-30T13:16:01Z
Lafayette,4,0,4,29107,2020-03-30T13:16:01Z
Lawrence,0,0,0,29109,2020-03-30T13:16:01Z
Lewis,0,0,0,29111,2020-03-30T13:16:01Z
Lincoln,2,1,1,29113,2020-03-30T13:16:01Z
Linn,0,0,0,29115,2020-03-30T13:16:01Z
Livingston,0,0,0,29117,2020-03-30T13:16:01Z
Macon,0,0,0,29121,2020-03-30T13:16:01Z
Madison,0,0,0,29123,2020-03-30T13:16:01Z
Maries,0,0,0,29125,2020-03-30T13:16:01Z
Marion,0,0,0,29127,2020-03-30T13:16:01Z
McDonald,1,0,1,NA,2020-03-30T13:16:01Z
Mercer,0,0,0,29129,2020-03-30T13:16:01Z
Miller,0,0,0,29131,2020-03-30T13:16:01Z
Mississippi,0,0,0,29133,2020-03-30T13:16:01Z
Moniteau,4,0,4,29135,2020-03-30T13:16:01Z
Monroe,0,0,0,29137,2020-03-30T13:16:01Z
Montgomery,3,0,3,29139,2020-03-30T13:16:01Z
Morgan,0,0,0,29141,2020-03-30T13:16:01Z
New Madrid,0,0,0,29143,2020-03-30T13:16:01Z
Newton,4,3,1,29145,2020-03-30T13:16:01Z
Nodaway,0,0,0,29147,2020-03-30T13:16:01Z
Oregon,0,0,0,29149,2020-03-30T13:16:01Z
Osage,0,0,0,29151,2020-03-30T13:16:01Z
Ozark,0,0,0,29153,2020-03-30T13:16:01Z
Pemiscot,1,0,1,29155,2020-03-30T13:16:01Z
Perry,7,4,3,29157,2020-03-30T13:16:01Z
Pettis,1,0,1,29159,2020-03-30T13:16:01Z
Phelps,0,0,0,29161,2020-03-30T13:16:01Z
Pike,0,0,0,29163,2020-03-30T13:16:01Z
Platte,6,1,5,29165,2020-03-30T13:16:01Z
Polk,0,0,0,29167,2020-03-30T13:16:01Z
Pulaski,5,1,4,29169,2020-03-30T13:16:01Z
Putnam,0,0,0,29171,2020-03-30T13:16:01Z
Ralls,1,1,0,29173,2020-03-30T13:16:01Z
Randolph,1,0,1,29175,2020-03-30T13:16:01Z
Ray,1,0,1,29177,2020-03-30T13:16:01Z
Reynolds,0,0,0,29179,2020-03-30T13:16:01Z
Ripley,2,0,2,29181,2020-03-30T13:16:01Z
Saline,0,0,0,29195,2020-03-30T13:16:01Z
Schuyler,0,0,0,29197,2020-03-30T13:16:01Z
Scotland,0,0,0,29199,2020-03-30T13:16:01Z
Scott,3,1,2,29201,2020-03-30T13:16:01Z
Shannon,0,0,0,29203,2020-03-30T13:16:01Z
Shelby,1,1,0,29205,2020-03-30T13:16:01Z
St. Charles,43,6,37,29183,2020-03-30T13:16:01Z
St. Clair,0,0,0,29185,2020-03-30T13:16:01Z
St. Francois,4,0,4,29187,2020-03-30T13:16:01Z
St. Louis City,97,3,94,29510,2020-03-30T13:16:01Z
St. Louis,336,25,311,29189,2020-03-30T13:16:01Z
Ste. Genevieve,0,0,0,29186,2020-03-30T13:16:01Z
Stoddard,2,0,2,29207,2020-03-30T13:16:01Z
Stone,0,0,0,29209,2020-03-30T13:16:01Z
Sullivan,0,0,0,29211,2020-03-30T13:16:01Z
Taney,2,0,2,29213,2020-03-30T13:16:01Z
Texas,1,0,1,29215,2020-03-30T13:16:01Z
Vernon,0,0,0,29217,2020-03-30T13:16:01Z
Warren,2,0,2,29219,2020-03-30T13:16:01Z
Washington,0,0,0,29221,2020-03-30T13:16:01Z
Wayne,0,0,0,29223,2020-03-30T13:16:01Z
Webster,0,0,0,29225,2020-03-30T13:16:01Z
Worth,0,0,0,29227,2020-03-30T13:16:01Z
Wright,3,1,2,29229,2020-03-30T13:16:01Z
TBD,8,2,6,NA,2020-03-30T13:16:01Z
Adair,1,0,1,29001,2020-03-30T01:16:01Z
Andrew,0,0,0,29003,2020-03-30T01:16:01Z
Atchison,1,1,0,29005,2020-03-30T01:16:01Z
Audrain,0,0,0,29007,2020-03-30T01:16:01Z
Barry,1,0,1,29009,2020-03-30T01:16:01Z
Barton,0,0,0,29011,2020-03-30T01:16:01Z
Bates,2,0,2,29013,2020-03-30T01:16:01Z
Benton,1,0,1,29015,2020-03-30T01:16:01Z
Bollinger,1,0,1,29017,2020-03-30T01:16:01Z
Boone,50,6,44,29019,2020-03-30T01:16:01Z
Buchanan,3,0,3,29021,2020-03-30T01:16:01Z
Butler,0,0,0,29023,2020-03-30T01:16:01Z
Caldwell,0,0,0,29025,2020-03-30T01:16:01Z
Callaway,8,1,7,29027,2020-03-30T01:16:01Z
Camden,7,1,6,29029,2020-03-30T01:16:01Z
Cape Girardeau,5,0,5,29031,2020-03-30T01:16:01Z
Carroll,0,0,0,29033,2020-03-30T01:16:01Z
Carter,2,1,1,29035,2020-03-30T01:16:01Z
Cass,8,2,6,29037,2020-03-30T01:16:01Z
Cedar,0,0,0,29039,2020-03-30T01:16:01Z
Chariton,1,0,1,29041,2020-03-30T01:16:01Z
Christian,7,3,4,29043,2020-03-30T01:16:01Z
Clark,0,0,0,29045,2020-03-30T01:16:01Z
Clay,11,0,11,29047,2020-03-30T01:16:01Z
Clinton,1,1,0,29049,2020-03-30T01:16:01Z
Cole,17,0,17,29051,2020-03-30T01:16:01Z
Cooper,1,0,1,29053,2020-03-30T01:16:01Z
Crawford,0,0,0,29055,2020-03-30T01:16:01Z
Dade,0,0,0,29057,2020-03-30T01:16:01Z
Dallas,0,0,0,29059,2020-03-30T01:16:01Z
Daviess,0,0,0,29061,2020-03-30T01:16:01Z
DeKalb,0,0,0,NA,2020-03-30T01:16:01Z
Dent,0,0,0,29065,2020-03-30T01:16:01Z
Douglas,0,0,0,29067,2020-03-30T01:16:01Z
Dunklin,3,0,3,29069,2020-03-30T01:16:01Z
Franklin,7,2,5,29071,2020-03-30T01:16:01Z
Gasconade,0,0,0,29073,2020-03-30T01:16:01Z
Gentry,0,0,0,29075,2020-03-30T01:16:01Z
Greene,41,9,32,29077,2020-03-30T01:16:01Z
Grundy,0,0,0,29079,2020-03-30T01:16:01Z
Harrison,0,0,0,29081,2020-03-30T01:16:01Z
Henry,1,0,1,29083,2020-03-30T01:16:01Z
Hickory,0,0,0,29085,2020-03-30T01:16:01Z
Holt,0,0,0,29087,2020-03-30T01:16:01Z
Howard,0,0,0,29089,2020-03-30T01:16:01Z
Howell,0,0,0,29091,2020-03-30T01:16:01Z
Iron,0,0,0,29093,2020-03-30T01:16:01Z
Jackson,48,3,45,29095,2020-03-30T01:16:01Z
Jasper,1,0,1,29097,2020-03-30T01:16:01Z
Jefferson,17,2,15,29099,2020-03-30T01:16:01Z
Johnson,9,1,8,29101,2020-03-30T01:16:01Z
Joplin,1,0,1,NA,2020-03-30T01:16:01Z
Kansas City,102,9,93,NA,2020-03-30T01:16:01Z
Knox,0,0,0,29103,2020-03-30T01:16:01Z
Laclede,0,0,0,29105,2020-03-30T01:16:01Z
Lafayette,4,0,4,29107,2020-03-30T01:16:01Z
Lawrence,0,0,0,29109,2020-03-30T01:16:01Z
Lewis,0,0,0,29111,2020-03-30T01:16:01Z
Lincoln,2,1,1,29113,2020-03-30T01:16:01Z
Linn,0,0,0,29115,2020-03-30T01:16:01Z
Livingston,0,0,0,29117,2020-03-30T01:16:01Z
Macon,0,0,0,29121,2020-03-30T01:16:01Z
Madison,0,0,0,29123,2020-03-30T01:16:01Z
Maries,0,0,0,29125,2020-03-30T01:16:01Z
Marion,0,0,0,29127,2020-03-30T01:16:01Z
McDonald,1,0,1,NA,2020-03-30T01:16:01Z
Mercer,0,0,0,29129,2020-03-30T01:16:01Z
Miller,0,0,0,29131,2020-03-30T01:16:01Z
Mississippi,0,0,0,29133,2020-03-30T01:16:01Z
Moniteau,4,0,4,29135,2020-03-30T01:16:01Z
Monroe,0,0,0,29137,2020-03-30T01:16:01Z
Montgomery,3,0,3,29139,2020-03-30T01:16:01Z
Morgan,0,0,0,29141,2020-03-30T01:16:01Z
New Madrid,0,0,0,29143,2020-03-30T01:16:01Z
Newton,4,3,1,29145,2020-03-30T01:16:01Z
Nodaway,0,0,0,29147,2020-03-30T01:16:01Z
Oregon,0,0,0,29149,2020-03-30T01:16:01Z
Osage,0,0,0,29151,2020-03-30T01:16:01Z
Ozark,0,0,0,29153,2020-03-30T01:16:01Z
Pemiscot,1,0,1,29155,2020-03-30T01:16:01Z
Perry,7,4,3,29157,2020-03-30T01:16:01Z
Pettis,1,0,1,29159,2020-03-30T01:16:01Z
Phelps,0,0,0,29161,2020-03-30T01:16:01Z
Pike,0,0,0,29163,2020-03-30T01:16:01Z
Platte,6,1,5,29165,2020-03-30T01:16:01Z
Polk,0,0,0,29167,2020-03-30T01:16:01Z
Pulaski,5,1,4,29169,2020-03-30T01:16:01Z
Putnam,0,0,0,29171,2020-03-30T01:16:01Z
Ralls,1,1,0,29173,2020-03-30T01:16:01Z
Randolph,1,0,1,29175,2020-03-30T01:16:01Z
Ray,1,0,1,29177,2020-03-30T01:16:01Z
Reynolds,0,0,0,29179,2020-03-30T01:16:01Z
Ripley,2,0,2,29181,2020-03-30T01:16:01Z
Saline,0,0,0,29195,2020-03-30T01:16:01Z
Schuyler,0,0,0,29197,2020-03-30T01:16:01Z
Scotland,0,0,0,29199,2020-03-30T01:16:01Z
Scott,3,1,2,29201,2020-03-30T01:16:01Z
Shannon,0,0,0,29203,2020-03-30T01:16:01Z
Shelby,1,1,0,29205,2020-03-30T01:16:01Z
St. Charles,43,6,37,29183,2020-03-30T01:16:01Z
St. Clair,0,0,0,29185,2020-03-30T01:16:01Z
St. Francois,4,0,4,29187,2020-03-30T01:16:01Z
St. Louis City,97,3,94,29510,2020-03-30T01:16:01Z
St. Louis,336,25,311,29189,2020-03-30T01:16:01Z
Ste. Genevieve,0,0,0,29186,2020-03-30T01:16:01Z
Stoddard,2,0,2,29207,2020-03-30T01:16:01Z
Stone,0,0,0,29209,2020-03-30T01:16:01Z
Sullivan,0,0,0,29211,2020-03-30T01:16:01Z
Taney,2,0,2,29213,2020-03-30T01:16:01Z
Texas,1,0,1,29215,2020-03-30T01:16:01Z
Vernon,0,0,0,29217,2020-03-30T01:16:01Z
Warren,2,0,2,29219,2020-03-30T01:16:01Z
Washington,0,0,0,29221,2020-03-30T01:16:01Z
Wayne,0,0,0,29223,2020-03-30T01:16:01Z
Webster,0,0,0,29225,2020-03-30T01:16:01Z
Worth,0,0,0,29227,2020-03-30T01:16:01Z
Wright,3,1,2,29229,2020-03-30T01:16:01Z
TBD,8,2,6,NA,2020-03-30T01:16:01Z
Adair,1,0,1,29001,2020-03-29T21:16:01Z
Andrew,0,0,0,29003,2020-03-29T21:16:01Z
Atchison,1,1,0,29005,2020-03-29T21:16:01Z
Audrain,0,0,0,29007,2020-03-29T21:16:01Z
Barry,1,0,1,29009,2020-03-29T21:16:01Z
Barton,0,0,0,29011,2020-03-29T21:16:01Z
Bates,2,0,2,29013,2020-03-29T21:16:01Z
Benton,1,0,1,29015,2020-03-29T21:16:01Z
Bollinger,1,0,1,29017,2020-03-29T21:16:01Z
Boone,50,6,44,29019,2020-03-29T21:16:01Z
Buchanan,3,0,3,29021,2020-03-29T21:16:01Z
Butler,0,0,0,29023,2020-03-29T21:16:01Z
Caldwell,0,0,0,29025,2020-03-29T21:16:01Z
Callaway,8,1,7,29027,2020-03-29T21:16:01Z
Camden,7,1,6,29029,2020-03-29T21:16:01Z
Cape Girardeau,5,0,5,29031,2020-03-29T21:16:01Z
Carroll,0,0,0,29033,2020-03-29T21:16:01Z
Carter,2,1,1,29035,2020-03-29T21:16:01Z
Cass,8,2,6,29037,2020-03-29T21:16:01Z
Cedar,0,0,0,29039,2020-03-29T21:16:01Z
Chariton,1,0,1,29041,2020-03-29T21:16:01Z
Christian,7,3,4,29043,2020-03-29T21:16:01Z
Clark,0,0,0,29045,2020-03-29T21:16:01Z
Clay,11,0,11,29047,2020-03-29T21:16:01Z
Clinton,1,1,0,29049,2020-03-29T21:16:01Z
Cole,17,0,17,29051,2020-03-29T21:16:01Z
Cooper,1,0,1,29053,2020-03-29T21:16:01Z
Crawford,0,0,0,29055,2020-03-29T21:16:01Z
Dade,0,0,0,29057,2020-03-29T21:16:01Z
Dallas,0,0,0,29059,2020-03-29T21:16:01Z
Daviess,0,0,0,29061,2020-03-29T21:16:01Z
DeKalb,0,0,0,NA,2020-03-29T21:16:01Z
Dent,0,0,0,29065,2020-03-29T21:16:01Z
Douglas,0,0,0,29067,2020-03-29T21:16:01Z
Dunklin,3,0,3,29069,2020-03-29T21:16:01Z
Franklin,7,2,5,29071,2020-03-29T21:16:01Z
Gasconade,0,0,0,29073,2020-03-29T21:16:01Z
Gentry,0,0,0,29075,2020-03-29T21:16:01Z
Greene,41,9,32,29077,2020-03-29T21:16:01Z
Grundy,0,0,0,29079,2020-03-29T21:16:01Z
Harrison,0,0,0,29081,2020-03-29T21:16:01Z
Henry,1,0,1,29083,2020-03-29T21:16:01Z
Hickory,0,0,0,29085,2020-03-29T21:16:01Z
Holt,0,0,0,29087,2020-03-29T21:16:01Z
Howard,0,0,0,29089,2020-03-29T21:16:01Z
Howell,0,0,0,29091,2020-03-29T21:16:01Z
Iron,0,0,0,29093,2020-03-29T21:16:01Z
Jackson,48,3,45,29095,2020-03-29T21:16:01Z
Jasper,1,0,1,29097,2020-03-29T21:16:01Z
Jefferson,17,2,15,29099,2020-03-29T21:16:01Z
Johnson,9,1,8,29101,2020-03-29T21:16:01Z
Joplin,1,0,1,NA,2020-03-29T21:16:01Z
Kansas City,102,9,93,NA,2020-03-29T21:16:01Z
Knox,0,0,0,29103,2020-03-29T21:16:01Z
Laclede,0,0,0,29105,2020-03-29T21:16:01Z
Lafayette,4,0,4,29107,2020-03-29T21:16:01Z
Lawrence,0,0,0,29109,2020-03-29T21:16:01Z
Lewis,0,0,0,29111,2020-03-29T21:16:01Z
Lincoln,2,1,1,29113,2020-03-29T21:16:01Z
Linn,0,0,0,29115,2020-03-29T21:16:01Z
Livingston,0,0,0,29117,2020-03-29T21:16:01Z
Macon,0,0,0,29121,2020-03-29T21:16:01Z
Madison,0,0,0,29123,2020-03-29T21:16:01Z
Maries,0,0,0,29125,2020-03-29T21:16:01Z
Marion,0,0,0,29127,2020-03-29T21:16:01Z
McDonald,1,0,1,NA,2020-03-29T21:16:01Z
Mercer,0,0,0,29129,2020-03-29T21:16:01Z
Miller,0,0,0,29131,2020-03-29T21:16:01Z
Mississippi,0,0,0,29133,2020-03-29T21:16:01Z
Moniteau,4,0,4,29135,2020-03-29T21:16:01Z
Monroe,0,0,0,29137,2020-03-29T21:16:01Z
Montgomery,3,0,3,29139,2020-03-29T21:16:01Z
Morgan,0,0,0,29141,2020-03-29T21:16:01Z
New Madrid,0,0,0,29143,2020-03-29T21:16:01Z
Newton,4,3,1,29145,2020-03-29T21:16:01Z
Nodaway,0,0,0,29147,2020-03-29T21:16:01Z
Oregon,0,0,0,29149,2020-03-29T21:16:01Z
Osage,0,0,0,29151,2020-03-29T21:16:01Z
Ozark,0,0,0,29153,2020-03-29T21:16:01Z
Pemiscot,1,0,1,29155,2020-03-29T21:16:01Z
Perry,7,4,3,29157,2020-03-29T21:16:01Z
Pettis,1,0,1,29159,2020-03-29T21:16:01Z
Phelps,0,0,0,29161,2020-03-29T21:16:01Z
Pike,0,0,0,29163,2020-03-29T21:16:01Z
Platte,6,1,5,29165,2020-03-29T21:16:01Z
Polk,0,0,0,29167,2020-03-29T21:16:01Z
Pulaski,5,1,4,29169,2020-03-29T21:16:01Z
Putnam,0,0,0,29171,2020-03-29T21:16:01Z
Ralls,1,1,0,29173,2020-03-29T21:16:01Z
Randolph,1,0,1,29175,2020-03-29T21:16:01Z
Ray,1,0,1,29177,2020-03-29T21:16:01Z
Reynolds,0,0,0,29179,2020-03-29T21:16:01Z
Ripley,2,0,2,29181,2020-03-29T21:16:01Z
Saline,0,0,0,29195,2020-03-29T21:16:01Z
Schuyler,0,0,0,29197,2020-03-29T21:16:01Z
Scotland,0,0,0,29199,2020-03-29T21:16:01Z
Scott,3,1,2,29201,2020-03-29T21:16:01Z
Shannon,0,0,0,29203,2020-03-29T21:16:01Z
Shelby,1,1,0,29205,2020-03-29T21:16:01Z
St. Charles,43,6,37,29183,2020-03-29T21:16:01Z
St. Clair,0,0,0,29185,2020-03-29T21:16:01Z
St. Francois,4,0,4,29187,2020-03-29T21:16:01Z
St. Louis City,97,3,94,29510,2020-03-29T21:16:01Z
St. Louis,336,25,311,29189,2020-03-29T21:16:01Z
Ste. Genevieve,0,0,0,29186,2020-03-29T21:16:01Z
Stoddard,2,0,2,29207,2020-03-29T21:16:01Z
Stone,0,0,0,29209,2020-03-29T21:16:01Z
Sullivan,0,0,0,29211,2020-03-29T21:16:01Z
Taney,2,0,2,29213,2020-03-29T21:16:01Z
Texas,1,0,1,29215,2020-03-29T21:16:01Z
Vernon,0,0,0,29217,2020-03-29T21:16:01Z
Warren,2,0,2,29219,2020-03-29T21:16:01Z
Washington,0,0,0,29221,2020-03-29T21:16:01Z
Wayne,0,0,0,29223,2020-03-29T21:16:01Z
Webster,0,0,0,29225,2020-03-29T21:16:01Z
Worth,0,0,0,29227,2020-03-29T21:16:01Z
Wright,3,1,2,29229,2020-03-29T21:16:01Z
TBD,8,2,6,NA,2020-03-29T21:16:01Z
Adair,1,0,1,29001,2020-03-29T17:16:02Z
Andrew,0,0,0,29003,2020-03-29T17:16:02Z
Atchison,1,1,0,29005,2020-03-29T17:16:02Z
Audrain,0,0,0,29007,2020-03-29T17:16:02Z
Barry,1,0,1,29009,2020-03-29T17:16:02Z
Barton,0,0,0,29011,2020-03-29T17:16:02Z
Bates,1,0,1,29013,2020-03-29T17:16:02Z
Benton,1,0,1,29015,2020-03-29T17:16:02Z
Bollinger,1,0,1,29017,2020-03-29T17:16:02Z
Boone,49,1,48,29019,2020-03-29T17:16:02Z
Buchanan,3,0,3,29021,2020-03-29T17:16:02Z
Butler,0,0,0,29023,2020-03-29T17:16:02Z
Caldwell,0,0,0,29025,2020-03-29T17:16:02Z
Callaway,6,0,6,29027,2020-03-29T17:16:02Z
Camden,4,2,2,29029,2020-03-29T17:16:02Z
Cape Girardeau,5,0,5,29031,2020-03-29T17:16:02Z
Carroll,0,0,0,29033,2020-03-29T17:16:02Z
Carter,2,1,1,29035,2020-03-29T17:16:02Z
Cass,8,2,6,29037,2020-03-29T17:16:02Z
Cedar,0,0,0,29039,2020-03-29T17:16:02Z
Chariton,1,0,1,29041,2020-03-29T17:16:02Z
Christian,6,3,3,29043,2020-03-29T17:16:02Z
Clark,0,0,0,29045,2020-03-29T17:16:02Z
Clay,10,0,10,29047,2020-03-29T17:16:02Z
Clinton,1,0,1,29049,2020-03-29T17:16:02Z
Cole,17,3,14,29051,2020-03-29T17:16:02Z
Cooper,1,0,1,29053,2020-03-29T17:16:02Z
Crawford,0,0,0,29055,2020-03-29T17:16:02Z
Dade,0,0,0,29057,2020-03-29T17:16:02Z
Dallas,0,0,0,29059,2020-03-29T17:16:02Z
Daviess,0,0,0,29061,2020-03-29T17:16:02Z
DeKalb,0,0,0,NA,2020-03-29T17:16:02Z
Dent,0,0,0,29065,2020-03-29T17:16:02Z
Douglas,0,0,0,29067,2020-03-29T17:16:02Z
Dunklin,3,0,3,29069,2020-03-29T17:16:02Z
Franklin,6,0,6,29071,2020-03-29T17:16:02Z
Gasconade,0,0,0,29073,2020-03-29T17:16:02Z
Gentry,0,0,0,29075,2020-03-29T17:16:02Z
Greene,41,18,23,29077,2020-03-29T17:16:02Z
Grundy,0,0,0,29079,2020-03-29T17:16:02Z
Harrison,0,0,0,29081,2020-03-29T17:16:02Z
Henry,1,1,0,29083,2020-03-29T17:16:02Z
Hickory,0,0,0,29085,2020-03-29T17:16:02Z
Holt,0,0,0,29087,2020-03-29T17:16:02Z
Howard,0,0,0,29089,2020-03-29T17:16:02Z
Howell,0,0,0,29091,2020-03-29T17:16:02Z
Iron,0,0,0,29093,2020-03-29T17:16:02Z
Jackson,43,5,38,29095,2020-03-29T17:16:02Z
Jasper,1,1,0,29097,2020-03-29T17:16:02Z
Jefferson,17,3,14,29099,2020-03-29T17:16:02Z
Johnson,9,1,8,29101,2020-03-29T17:16:02Z
Joplin,1,0,1,NA,2020-03-29T17:16:02Z
Kansas City,94,1,93,NA,2020-03-29T17:16:02Z
Knox,0,0,0,29103,2020-03-29T17:16:02Z
Laclede,0,0,0,29105,2020-03-29T17:16:02Z
Lafayette,4,0,4,29107,2020-03-29T17:16:02Z
Lawrence,0,0,0,29109,2020-03-29T17:16:02Z
Lewis,0,0,0,29111,2020-03-29T17:16:02Z
Lincoln,2,1,1,29113,2020-03-29T17:16:02Z
Linn,0,0,0,29115,2020-03-29T17:16:02Z
Livingston,0,0,0,29117,2020-03-29T17:16:02Z
Macon,0,0,0,29121,2020-03-29T17:16:02Z
Madison,0,0,0,29123,2020-03-29T17:16:02Z
Maries,0,0,0,29125,2020-03-29T17:16:02Z
Marion,0,0,0,29127,2020-03-29T17:16:02Z
McDonald,1,0,1,NA,2020-03-29T17:16:02Z
Mercer,0,0,0,29129,2020-03-29T17:16:02Z
Miller,0,0,0,29131,2020-03-29T17:16:02Z
Mississippi,0,0,0,29133,2020-03-29T17:16:02Z
Moniteau,3,0,3,29135,2020-03-29T17:16:02Z
Monroe,0,0,0,29137,2020-03-29T17:16:02Z
Montgomery,3,0,3,29139,2020-03-29T17:16:02Z
Morgan,0,0,0,29141,2020-03-29T17:16:02Z
New Madrid,0,0,0,29143,2020-03-29T17:16:02Z
Newton,4,3,1,29145,2020-03-29T17:16:02Z
Nodaway,0,0,0,29147,2020-03-29T17:16:02Z
Oregon,0,0,0,29149,2020-03-29T17:16:02Z
Osage,0,0,0,29151,2020-03-29T17:16:02Z
Ozark,0,0,0,29153,2020-03-29T17:16:02Z
Pemiscot,1,0,1,29155,2020-03-29T17:16:02Z
Perry,7,4,3,29157,2020-03-29T17:16:02Z
Pettis,1,0,1,29159,2020-03-29T17:16:02Z
Phelps,0,0,0,29161,2020-03-29T17:16:02Z
Pike,0,0,0,29163,2020-03-29T17:16:02Z
Platte,6,0,6,29165,2020-03-29T17:16:02Z
Polk,0,0,0,29167,2020-03-29T17:16:02Z
Pulaski,5,1,4,29169,2020-03-29T17:16:02Z
Putnam,0,0,0,29171,2020-03-29T17:16:02Z
Ralls,1,1,0,29173,2020-03-29T17:16:02Z
Randolph,1,0,1,29175,2020-03-29T17:16:02Z
Ray,1,0,1,29177,2020-03-29T17:16:02Z
Reynolds,0,0,0,29179,2020-03-29T17:16:02Z
Ripley,1,0,1,29181,2020-03-29T17:16:02Z
Saline,0,0,0,29195,2020-03-29T17:16:02Z
Schuyler,0,0,0,29197,2020-03-29T17:16:02Z
Scotland,0,0,0,29199,2020-03-29T17:16:02Z
Scott,3,1,2,29201,2020-03-29T17:16:02Z
Shannon,0,0,0,29203,2020-03-29T17:16:02Z
Shelby,1,1,0,29205,2020-03-29T17:16:02Z
St. Charles,37,6,31,29183,2020-03-29T17:16:02Z
St. Clair,0,0,0,29185,2020-03-29T17:16:02Z
St. Francois,4,1,3,29187,2020-03-29T17:16:02Z
St. Louis City,93,10,83,29510,2020-03-29T17:16:02Z
St. Louis,313,26,287,29189,2020-03-29T17:16:02Z
Ste. Genevieve,0,0,0,29186,2020-03-29T17:16:02Z
Stoddard,1,0,1,29207,2020-03-29T17:16:02Z
Stone,0,0,0,29209,2020-03-29T17:16:02Z
Sullivan,0,0,0,29211,2020-03-29T17:16:02Z
Taney,2,0,2,29213,2020-03-29T17:16:02Z
Texas,1,0,1,29215,2020-03-29T17:16:02Z
Vernon,0,0,0,29217,2020-03-29T17:16:02Z
Warren,1,0,1,29219,2020-03-29T17:16:02Z
Washington,0,0,0,29221,2020-03-29T17:16:02Z
Wayne,0,0,0,29223,2020-03-29T17:16:02Z
Webster,0,0,0,29225,2020-03-29T17:16:02Z
Worth,0,0,0,29227,2020-03-29T17:16:02Z
Wright,1,0,1,29229,2020-03-29T17:16:02Z
TBD,5,0,5,NA,2020-03-29T17:16:02Z
Adair,1,0,1,29001,2020-03-29T13:16:02Z
Andrew,0,0,0,29003,2020-03-29T13:16:02Z
Atchison,1,1,0,29005,2020-03-29T13:16:02Z
Audrain,0,0,0,29007,2020-03-29T13:16:02Z
Barry,1,0,1,29009,2020-03-29T13:16:02Z
Barton,0,0,0,29011,2020-03-29T13:16:02Z
Bates,1,0,1,29013,2020-03-29T13:16:02Z
Benton,1,0,1,29015,2020-03-29T13:16:02Z
Bollinger,1,0,1,29017,2020-03-29T13:16:02Z
Boone,49,1,48,29019,2020-03-29T13:16:02Z
Buchanan,3,0,3,29021,2020-03-29T13:16:02Z
Butler,0,0,0,29023,2020-03-29T13:16:02Z
Caldwell,0,0,0,29025,2020-03-29T13:16:02Z
Callaway,6,0,6,29027,2020-03-29T13:16:02Z
Camden,4,2,2,29029,2020-03-29T13:16:02Z
Cape Girardeau,5,0,5,29031,2020-03-29T13:16:02Z
Carroll,0,0,0,29033,2020-03-29T13:16:02Z
Carter,2,1,1,29035,2020-03-29T13:16:02Z
Cass,8,2,6,29037,2020-03-29T13:16:02Z
Cedar,0,0,0,29039,2020-03-29T13:16:02Z
Chariton,1,0,1,29041,2020-03-29T13:16:02Z
Christian,6,3,3,29043,2020-03-29T13:16:02Z
Clark,0,0,0,29045,2020-03-29T13:16:02Z
Clay,10,0,10,29047,2020-03-29T13:16:02Z
Clinton,1,0,1,29049,2020-03-29T13:16:02Z
Cole,17,3,14,29051,2020-03-29T13:16:02Z
Cooper,1,0,1,29053,2020-03-29T13:16:02Z
Crawford,0,0,0,29055,2020-03-29T13:16:02Z
Dade,0,0,0,29057,2020-03-29T13:16:02Z
Dallas,0,0,0,29059,2020-03-29T13:16:02Z
Daviess,0,0,0,29061,2020-03-29T13:16:02Z
DeKalb,0,0,0,NA,2020-03-29T13:16:02Z
Dent,0,0,0,29065,2020-03-29T13:16:02Z
Douglas,0,0,0,29067,2020-03-29T13:16:02Z
Dunklin,3,0,3,29069,2020-03-29T13:16:02Z
Franklin,6,0,6,29071,2020-03-29T13:16:02Z
Gasconade,0,0,0,29073,2020-03-29T13:16:02Z
Gentry,0,0,0,29075,2020-03-29T13:16:02Z
Greene,41,18,23,29077,2020-03-29T13:16:02Z
Grundy,0,0,0,29079,2020-03-29T13:16:02Z
Harrison,0,0,0,29081,2020-03-29T13:16:02Z
Henry,1,1,0,29083,2020-03-29T13:16:02Z
Hickory,0,0,0,29085,2020-03-29T13:16:02Z
Holt,0,0,0,29087,2020-03-29T13:16:02Z
Howard,0,0,0,29089,2020-03-29T13:16:02Z
Howell,0,0,0,29091,2020-03-29T13:16:02Z
Iron,0,0,0,29093,2020-03-29T13:16:02Z
Jackson,43,5,38,29095,2020-03-29T13:16:02Z
Jasper,1,1,0,29097,2020-03-29T13:16:02Z
Jefferson,17,3,14,29099,2020-03-29T13:16:02Z
Johnson,9,1,8,29101,2020-03-29T13:16:02Z
Joplin,1,0,1,NA,2020-03-29T13:16:02Z
Kansas City,94,1,93,NA,2020-03-29T13:16:02Z
Knox,0,0,0,29103,2020-03-29T13:16:02Z
Laclede,0,0,0,29105,2020-03-29T13:16:02Z
Lafayette,4,0,4,29107,2020-03-29T13:16:02Z
Lawrence,0,0,0,29109,2020-03-29T13:16:02Z
Lewis,0,0,0,29111,2020-03-29T13:16:02Z
Lincoln,2,1,1,29113,2020-03-29T13:16:02Z
Linn,0,0,0,29115,2020-03-29T13:16:02Z
Livingston,0,0,0,29117,2020-03-29T13:16:02Z
Macon,0,0,0,29121,2020-03-29T13:16:02Z
Madison,0,0,0,29123,2020-03-29T13:16:02Z
Maries,0,0,0,29125,2020-03-29T13:16:02Z
Marion,0,0,0,29127,2020-03-29T13:16:02Z
McDonald,1,0,1,NA,2020-03-29T13:16:02Z
Mercer,0,0,0,29129,2020-03-29T13:16:02Z
Miller,0,0,0,29131,2020-03-29T13:16:02Z
Mississippi,0,0,0,29133,2020-03-29T13:16:02Z
Moniteau,3,0,3,29135,2020-03-29T13:16:02Z
Monroe,0,0,0,29137,2020-03-29T13:16:02Z
Montgomery,3,0,3,29139,2020-03-29T13:16:02Z
Morgan,0,0,0,29141,2020-03-29T13:16:02Z
New Madrid,0,0,0,29143,2020-03-29T13:16:02Z
Newton,4,3,1,29145,2020-03-29T13:16:02Z
Nodaway,0,0,0,29147,2020-03-29T13:16:02Z
Oregon,0,0,0,29149,2020-03-29T13:16:02Z
Osage,0,0,0,29151,2020-03-29T13:16:02Z
Ozark,0,0,0,29153,2020-03-29T13:16:02Z
Pemiscot,1,0,1,29155,2020-03-29T13:16:02Z
Perry,7,4,3,29157,2020-03-29T13:16:02Z
Pettis,1,0,1,29159,2020-03-29T13:16:02Z
Phelps,0,0,0,29161,2020-03-29T13:16:02Z
Pike,0,0,0,29163,2020-03-29T13:16:02Z
Platte,6,0,6,29165,2020-03-29T13:16:02Z
Polk,0,0,0,29167,2020-03-29T13:16:02Z
Pulaski,5,1,4,29169,2020-03-29T13:16:02Z
Putnam,0,0,0,29171,2020-03-29T13:16:02Z
Ralls,1,1,0,29173,2020-03-29T13:16:02Z
Randolph,1,0,1,29175,2020-03-29T13:16:02Z
Ray,1,0,1,29177,2020-03-29T13:16:02Z
Reynolds,0,0,0,29179,2020-03-29T13:16:02Z
Ripley,1,0,1,29181,2020-03-29T13:16:02Z
Saline,0,0,0,29195,2020-03-29T13:16:02Z
Schuyler,0,0,0,29197,2020-03-29T13:16:02Z
Scotland,0,0,0,29199,2020-03-29T13:16:02Z
Scott,3,1,2,29201,2020-03-29T13:16:02Z
Shannon,0,0,0,29203,2020-03-29T13:16:02Z
Shelby,1,1,0,29205,2020-03-29T13:16:02Z
St. Charles,37,6,31,29183,2020-03-29T13:16:02Z
St. Clair,0,0,0,29185,2020-03-29T13:16:02Z
St. Francois,4,1,3,29187,2020-03-29T13:16:02Z
St. Louis City,93,10,83,29510,2020-03-29T13:16:02Z
St. Louis,313,26,287,29189,2020-03-29T13:16:02Z
Ste. Genevieve,0,0,0,29186,2020-03-29T13:16:02Z
Stoddard,1,0,1,29207,2020-03-29T13:16:02Z
Stone,0,0,0,29209,2020-03-29T13:16:02Z
Sullivan,0,0,0,29211,2020-03-29T13:16:02Z
Taney,2,0,2,29213,2020-03-29T13:16:02Z
Texas,1,0,1,29215,2020-03-29T13:16:02Z
Vernon,0,0,0,29217,2020-03-29T13:16:02Z
Warren,1,0,1,29219,2020-03-29T13:16:02Z
Washington,0,0,0,29221,2020-03-29T13:16:02Z
Wayne,0,0,0,29223,2020-03-29T13:16:02Z
Webster,0,0,0,29225,2020-03-29T13:16:02Z
Worth,0,0,0,29227,2020-03-29T13:16:02Z
Wright,1,0,1,29229,2020-03-29T13:16:02Z
TBD,5,0,5,NA,2020-03-29T13:16:02Z
Adair,1,0,1,29001,2020-03-29T01:16:01Z
Andrew,0,0,0,29003,2020-03-29T01:16:01Z
Atchison,1,1,0,29005,2020-03-29T01:16:01Z
Audrain,0,0,0,29007,2020-03-29T01:16:01Z
Barry,1,0,1,29009,2020-03-29T01:16:01Z
Barton,0,0,0,29011,2020-03-29T01:16:01Z
Bates,1,0,1,29013,2020-03-29T01:16:01Z
Benton,1,0,1,29015,2020-03-29T01:16:01Z
Bollinger,1,0,1,29017,2020-03-29T01:16:01Z
Boone,49,1,48,29019,2020-03-29T01:16:01Z
Buchanan,3,0,3,29021,2020-03-29T01:16:01Z
Butler,0,0,0,29023,2020-03-29T01:16:01Z
Caldwell,0,0,0,29025,2020-03-29T01:16:01Z
Callaway,6,0,6,29027,2020-03-29T01:16:01Z
Camden,4,2,2,29029,2020-03-29T01:16:01Z
Cape Girardeau,5,0,5,29031,2020-03-29T01:16:01Z
Carroll,0,0,0,29033,2020-03-29T01:16:01Z
Carter,2,1,1,29035,2020-03-29T01:16:01Z
Cass,8,2,6,29037,2020-03-29T01:16:01Z
Cedar,0,0,0,29039,2020-03-29T01:16:01Z
Chariton,1,0,1,29041,2020-03-29T01:16:01Z
Christian,6,3,3,29043,2020-03-29T01:16:01Z
Clark,0,0,0,29045,2020-03-29T01:16:01Z
Clay,10,0,10,29047,2020-03-29T01:16:01Z
Clinton,1,0,1,29049,2020-03-29T01:16:01Z
Cole,17,3,14,29051,2020-03-29T01:16:01Z
Cooper,1,0,1,29053,2020-03-29T01:16:01Z
Crawford,0,0,0,29055,2020-03-29T01:16:01Z
Dade,0,0,0,29057,2020-03-29T01:16:01Z
Dallas,0,0,0,29059,2020-03-29T01:16:01Z
Daviess,0,0,0,29061,2020-03-29T01:16:01Z
DeKalb,0,0,0,NA,2020-03-29T01:16:01Z
Dent,0,0,0,29065,2020-03-29T01:16:01Z
Douglas,0,0,0,29067,2020-03-29T01:16:01Z
Dunklin,3,0,3,29069,2020-03-29T01:16:01Z
Franklin,6,0,6,29071,2020-03-29T01:16:01Z
Gasconade,0,0,0,29073,2020-03-29T01:16:01Z
Gentry,0,0,0,29075,2020-03-29T01:16:01Z
Greene,41,18,23,29077,2020-03-29T01:16:01Z
Grundy,0,0,0,29079,2020-03-29T01:16:01Z
Harrison,0,0,0,29081,2020-03-29T01:16:01Z
Henry,1,1,0,29083,2020-03-29T01:16:01Z
Hickory,0,0,0,29085,2020-03-29T01:16:01Z
Holt,0,0,0,29087,2020-03-29T01:16:01Z
Howard,0,0,0,29089,2020-03-29T01:16:01Z
Howell,0,0,0,29091,2020-03-29T01:16:01Z
Iron,0,0,0,29093,2020-03-29T01:16:01Z
Jackson,43,5,38,29095,2020-03-29T01:16:01Z
Jasper,1,1,0,29097,2020-03-29T01:16:01Z
Jefferson,17,3,14,29099,2020-03-29T01:16:01Z
Johnson,9,1,8,29101,2020-03-29T01:16:01Z
Joplin,1,0,1,NA,2020-03-29T01:16:01Z
Kansas City,94,1,93,NA,2020-03-29T01:16:01Z
Knox,0,0,0,29103,2020-03-29T01:16:01Z
Laclede,0,0,0,29105,2020-03-29T01:16:01Z
Lafayette,4,0,4,29107,2020-03-29T01:16:01Z
Lawrence,0,0,0,29109,2020-03-29T01:16:01Z
Lewis,0,0,0,29111,2020-03-29T01:16:01Z
Lincoln,2,1,1,29113,2020-03-29T01:16:01Z
Linn,0,0,0,29115,2020-03-29T01:16:01Z
Livingston,0,0,0,29117,2020-03-29T01:16:01Z
Macon,0,0,0,29121,2020-03-29T01:16:01Z
Madison,0,0,0,29123,2020-03-29T01:16:01Z
Maries,0,0,0,29125,2020-03-29T01:16:01Z
Marion,0,0,0,29127,2020-03-29T01:16:01Z
McDonald,1,0,1,NA,2020-03-29T01:16:01Z
Mercer,0,0,0,29129,2020-03-29T01:16:01Z
Miller,0,0,0,29131,2020-03-29T01:16:01Z
Mississippi,0,0,0,29133,2020-03-29T01:16:01Z
Moniteau,3,0,3,29135,2020-03-29T01:16:01Z
Monroe,0,0,0,29137,2020-03-29T01:16:01Z
Montgomery,3,0,3,29139,2020-03-29T01:16:01Z
Morgan,0,0,0,29141,2020-03-29T01:16:01Z
New Madrid,0,0,0,29143,2020-03-29T01:16:01Z
Newton,4,3,1,29145,2020-03-29T01:16:01Z
Nodaway,0,0,0,29147,2020-03-29T01:16:01Z
Oregon,0,0,0,29149,2020-03-29T01:16:01Z
Osage,0,0,0,29151,2020-03-29T01:16:01Z
Ozark,0,0,0,29153,2020-03-29T01:16:01Z
Pemiscot,1,0,1,29155,2020-03-29T01:16:01Z
Perry,7,4,3,29157,2020-03-29T01:16:01Z
Pettis,1,0,1,29159,2020-03-29T01:16:01Z
Phelps,0,0,0,29161,2020-03-29T01:16:01Z
Pike,0,0,0,29163,2020-03-29T01:16:01Z
Platte,6,0,6,29165,2020-03-29T01:16:01Z
Polk,0,0,0,29167,2020-03-29T01:16:01Z
Pulaski,5,1,4,29169,2020-03-29T01:16:01Z
Putnam,0,0,0,29171,2020-03-29T01:16:01Z
Ralls,1,1,0,29173,2020-03-29T01:16:01Z
Randolph,1,0,1,29175,2020-03-29T01:16:01Z
Ray,1,0,1,29177,2020-03-29T01:16:01Z
Reynolds,0,0,0,29179,2020-03-29T01:16:01Z
Ripley,1,0,1,29181,2020-03-29T01:16:01Z
Saline,0,0,0,29195,2020-03-29T01:16:01Z
Schuyler,0,0,0,29197,2020-03-29T01:16:01Z
Scotland,0,0,0,29199,2020-03-29T01:16:01Z
Scott,3,1,2,29201,2020-03-29T01:16:01Z
Shannon,0,0,0,29203,2020-03-29T01:16:01Z
Shelby,1,1,0,29205,2020-03-29T01:16:01Z
St. Charles,37,6,31,29183,2020-03-29T01:16:01Z
St. Clair,0,0,0,29185,2020-03-29T01:16:01Z
St. Francois,4,1,3,29187,2020-03-29T01:16:01Z
St. Louis City,93,10,83,29510,2020-03-29T01:16:01Z
St. Louis,313,26,287,29189,2020-03-29T01:16:01Z
Ste. Genevieve,0,0,0,29186,2020-03-29T01:16:01Z
Stoddard,1,0,1,29207,2020-03-29T01:16:01Z
Stone,0,0,0,29209,2020-03-29T01:16:01Z
Sullivan,0,0,0,29211,2020-03-29T01:16:01Z
Taney,2,0,2,29213,2020-03-29T01:16:01Z
Texas,1,0,1,29215,2020-03-29T01:16:01Z
Vernon,0,0,0,29217,2020-03-29T01:16:01Z
Warren,1,0,1,29219,2020-03-29T01:16:01Z
Washington,0,0,0,29221,2020-03-29T01:16:01Z
Wayne,0,0,0,29223,2020-03-29T01:16:01Z
Webster,0,0,0,29225,2020-03-29T01:16:01Z
Worth,0,0,0,29227,2020-03-29T01:16:01Z
Wright,1,0,1,29229,2020-03-29T01:16:01Z
TBD,5,0,5,NA,2020-03-29T01:16:01Z
Adair,1,0,1,29001,2020-03-28T21:16:01Z
Andrew,0,0,0,29003,2020-03-28T21:16:01Z
Atchison,1,1,0,29005,2020-03-28T21:16:01Z
Audrain,0,0,0,29007,2020-03-28T21:16:01Z
Barry,1,0,1,29009,2020-03-28T21:16:01Z
Barton,0,0,0,29011,2020-03-28T21:16:01Z
Bates,1,0,1,29013,2020-03-28T21:16:01Z
Benton,1,0,1,29015,2020-03-28T21:16:01Z
Bollinger,1,0,1,29017,2020-03-28T21:16:01Z
Boone,49,1,48,29019,2020-03-28T21:16:01Z
Buchanan,3,0,3,29021,2020-03-28T21:16:01Z
Butler,0,0,0,29023,2020-03-28T21:16:01Z
Caldwell,0,0,0,29025,2020-03-28T21:16:01Z
Callaway,6,0,6,29027,2020-03-28T21:16:01Z
Camden,4,2,2,29029,2020-03-28T21:16:01Z
Cape Girardeau,5,0,5,29031,2020-03-28T21:16:01Z
Carroll,0,0,0,29033,2020-03-28T21:16:01Z
Carter,2,1,1,29035,2020-03-28T21:16:01Z
Cass,8,2,6,29037,2020-03-28T21:16:01Z
Cedar,0,0,0,29039,2020-03-28T21:16:01Z
Chariton,1,0,1,29041,2020-03-28T21:16:01Z
Christian,6,3,3,29043,2020-03-28T21:16:01Z
Clark,0,0,0,29045,2020-03-28T21:16:01Z
Clay,10,0,10,29047,2020-03-28T21:16:01Z
Clinton,1,0,1,29049,2020-03-28T21:16:01Z
Cole,17,3,14,29051,2020-03-28T21:16:01Z
Cooper,1,0,1,29053,2020-03-28T21:16:01Z
Crawford,0,0,0,29055,2020-03-28T21:16:01Z
Dade,0,0,0,29057,2020-03-28T21:16:01Z
Dallas,0,0,0,29059,2020-03-28T21:16:01Z
Daviess,0,0,0,29061,2020-03-28T21:16:01Z
DeKalb,0,0,0,NA,2020-03-28T21:16:01Z
Dent,0,0,0,29065,2020-03-28T21:16:01Z
Douglas,0,0,0,29067,2020-03-28T21:16:01Z
Dunklin,3,0,3,29069,2020-03-28T21:16:01Z
Franklin,6,0,6,29071,2020-03-28T21:16:01Z
Gasconade,0,0,0,29073,2020-03-28T21:16:01Z
Gentry,0,0,0,29075,2020-03-28T21:16:01Z
Greene,41,18,23,29077,2020-03-28T21:16:01Z
Grundy,0,0,0,29079,2020-03-28T21:16:01Z
Harrison,0,0,0,29081,2020-03-28T21:16:01Z
Henry,1,1,0,29083,2020-03-28T21:16:01Z
Hickory,0,0,0,29085,2020-03-28T21:16:01Z
Holt,0,0,0,29087,2020-03-28T21:16:01Z
Howard,0,0,0,29089,2020-03-28T21:16:01Z
Howell,0,0,0,29091,2020-03-28T21:16:01Z
Iron,0,0,0,29093,2020-03-28T21:16:01Z
Jackson,43,5,38,29095,2020-03-28T21:16:01Z
Jasper,1,1,0,29097,2020-03-28T21:16:01Z
Jefferson,17,3,14,29099,2020-03-28T21:16:01Z
Johnson,9,1,8,29101,2020-03-28T21:16:01Z
Joplin,1,0,1,NA,2020-03-28T21:16:01Z
Kansas City,94,1,93,NA,2020-03-28T21:16:01Z
Knox,0,0,0,29103,2020-03-28T21:16:01Z
Laclede,0,0,0,29105,2020-03-28T21:16:01Z
Lafayette,4,0,4,29107,2020-03-28T21:16:01Z
Lawrence,0,0,0,29109,2020-03-28T21:16:01Z
Lewis,0,0,0,29111,2020-03-28T21:16:01Z
Lincoln,2,1,1,29113,2020-03-28T21:16:01Z
Linn,0,0,0,29115,2020-03-28T21:16:01Z
Livingston,0,0,0,29117,2020-03-28T21:16:01Z
Macon,0,0,0,29121,2020-03-28T21:16:01Z
Madison,0,0,0,29123,2020-03-28T21:16:01Z
Maries,0,0,0,29125,2020-03-28T21:16:01Z
Marion,0,0,0,29127,2020-03-28T21:16:01Z
McDonald,1,0,1,NA,2020-03-28T21:16:01Z
Mercer,0,0,0,29129,2020-03-28T21:16:01Z
Miller,0,0,0,29131,2020-03-28T21:16:01Z
Mississippi,0,0,0,29133,2020-03-28T21:16:01Z
Moniteau,3,0,3,29135,2020-03-28T21:16:01Z
Monroe,0,0,0,29137,2020-03-28T21:16:01Z
Montgomery,3,0,3,29139,2020-03-28T21:16:01Z
Morgan,0,0,0,29141,2020-03-28T21:16:01Z
New Madrid,0,0,0,29143,2020-03-28T21:16:01Z
Newton,4,3,1,29145,2020-03-28T21:16:01Z
Nodaway,0,0,0,29147,2020-03-28T21:16:01Z
Oregon,0,0,0,29149,2020-03-28T21:16:01Z
Osage,0,0,0,29151,2020-03-28T21:16:01Z
Ozark,0,0,0,29153,2020-03-28T21:16:01Z
Pemiscot,1,0,1,29155,2020-03-28T21:16:01Z
Perry,7,4,3,29157,2020-03-28T21:16:01Z
Pettis,1,0,1,29159,2020-03-28T21:16:01Z
Phelps,0,0,0,29161,2020-03-28T21:16:01Z
Pike,0,0,0,29163,2020-03-28T21:16:01Z
Platte,6,0,6,29165,2020-03-28T21:16:01Z
Polk,0,0,0,29167,2020-03-28T21:16:01Z
Pulaski,5,1,4,29169,2020-03-28T21:16:01Z
Putnam,0,0,0,29171,2020-03-28T21:16:01Z
Ralls,1,1,0,29173,2020-03-28T21:16:01Z
Randolph,1,0,1,29175,2020-03-28T21:16:01Z
Ray,1,0,1,29177,2020-03-28T21:16:01Z
Reynolds,0,0,0,29179,2020-03-28T21:16:01Z
Ripley,1,0,1,29181,2020-03-28T21:16:01Z
Saline,0,0,0,29195,2020-03-28T21:16:01Z
Schuyler,0,0,0,29197,2020-03-28T21:16:01Z
Scotland,0,0,0,29199,2020-03-28T21:16:01Z
Scott,3,1,2,29201,2020-03-28T21:16:01Z
Shannon,0,0,0,29203,2020-03-28T21:16:01Z
Shelby,1,1,0,29205,2020-03-28T21:16:01Z
St. Charles,37,6,31,29183,2020-03-28T21:16:01Z
St. Clair,0,0,0,29185,2020-03-28T21:16:01Z
St. Francois,4,1,3,29187,2020-03-28T21:16:01Z
St. Louis City,93,10,83,29510,2020-03-28T21:16:01Z
St. Louis,313,26,287,29189,2020-03-28T21:16:01Z
Ste. Genevieve,0,0,0,29186,2020-03-28T21:16:01Z
Stoddard,1,0,1,29207,2020-03-28T21:16:01Z
Stone,0,0,0,29209,2020-03-28T21:16:01Z
Sullivan,0,0,0,29211,2020-03-28T21:16:01Z
Taney,2,0,2,29213,2020-03-28T21:16:01Z
Texas,1,0,1,29215,2020-03-28T21:16:01Z
Vernon,0,0,0,29217,2020-03-28T21:16:01Z
Warren,1,0,1,29219,2020-03-28T21:16:01Z
Washington,0,0,0,29221,2020-03-28T21:16:01Z
Wayne,0,0,0,29223,2020-03-28T21:16:01Z
Webster,0,0,0,29225,2020-03-28T21:16:01Z
Worth,0,0,0,29227,2020-03-28T21:16:01Z
Wright,1,0,1,29229,2020-03-28T21:16:01Z
TBD,5,0,5,NA,2020-03-28T21:16:01Z
Adair,1,0,1,29001,2020-03-28T17:16:01Z
Andrew,0,0,0,29003,2020-03-28T17:16:01Z
Atchison,1,1,0,29005,2020-03-28T17:16:01Z
Audrain,0,0,0,29007,2020-03-28T17:16:01Z
Barry,0,0,0,29009,2020-03-28T17:16:01Z
Barton,0,0,0,29011,2020-03-28T17:16:01Z
Bates,1,0,1,29013,2020-03-28T17:16:01Z
Benton,1,0,1,29015,2020-03-28T17:16:01Z
Bollinger,1,0,1,29017,2020-03-28T17:16:01Z
Boone,37,1,36,29019,2020-03-28T17:16:01Z
Buchanan,2,0,2,29021,2020-03-28T17:16:01Z
Butler,0,0,0,29023,2020-03-28T17:16:01Z
Caldwell,0,0,0,29025,2020-03-28T17:16:01Z
Callaway,3,0,3,29027,2020-03-28T17:16:01Z
Camden,1,1,0,29029,2020-03-28T17:16:01Z
Cape Girardeau,5,0,5,29031,2020-03-28T17:16:01Z
Carroll,0,0,0,29033,2020-03-28T17:16:01Z
Carter,1,1,0,29035,2020-03-28T17:16:01Z
Cass,8,2,6,29037,2020-03-28T17:16:01Z
Cedar,0,0,0,29039,2020-03-28T17:16:01Z
Chariton,1,0,1,29041,2020-03-28T17:16:01Z
Christian,3,3,0,29043,2020-03-28T17:16:01Z
Clark,0,0,0,29045,2020-03-28T17:16:01Z
Clay,9,0,9,29047,2020-03-28T17:16:01Z
Clinton,1,0,1,29049,2020-03-28T17:16:01Z
Cole,10,3,7,29051,2020-03-28T17:16:01Z
Cooper,1,0,1,29053,2020-03-28T17:16:01Z
Crawford,0,0,0,29055,2020-03-28T17:16:01Z
Dade,0,0,0,29057,2020-03-28T17:16:01Z
Dallas,0,0,0,29059,2020-03-28T17:16:01Z
Daviess,0,0,0,29061,2020-03-28T17:16:01Z
DeKalb,0,0,0,NA,2020-03-28T17:16:01Z
Dent,0,0,0,29065,2020-03-28T17:16:01Z
Douglas,0,0,0,29067,2020-03-28T17:16:01Z
Dunklin,3,0,3,29069,2020-03-28T17:16:01Z
Franklin,4,0,4,29071,2020-03-28T17:16:01Z
Gasconade,0,0,0,29073,2020-03-28T17:16:01Z
Gentry,0,0,0,29075,2020-03-28T17:16:01Z
Greene,31,18,13,29077,2020-03-28T17:16:01Z
Grundy,0,0,0,29079,2020-03-28T17:16:01Z
Harrison,0,0,0,29081,2020-03-28T17:16:01Z
Henry,1,1,0,29083,2020-03-28T17:16:01Z
Hickory,0,0,0,29085,2020-03-28T17:16:01Z
Holt,0,0,0,29087,2020-03-28T17:16:01Z
Howard,0,0,0,29089,2020-03-28T17:16:01Z
Howell,0,0,0,29091,2020-03-28T17:16:01Z
Iron,0,0,0,29093,2020-03-28T17:16:01Z
Jackson,41,5,36,29095,2020-03-28T17:16:01Z
Jasper,1,1,0,29097,2020-03-28T17:16:01Z
Jefferson,15,2,13,29099,2020-03-28T17:16:01Z
Johnson,8,1,7,29101,2020-03-28T17:16:01Z
Joplin,1,0,1,NA,2020-03-28T17:16:01Z
Kansas City,78,1,77,NA,2020-03-28T17:16:01Z
Knox,0,0,0,29103,2020-03-28T17:16:01Z
Laclede,0,0,0,29105,2020-03-28T17:16:01Z
Lafayette,4,0,4,29107,2020-03-28T17:16:01Z
Lawrence,0,0,0,29109,2020-03-28T17:16:01Z
Lewis,0,0,0,29111,2020-03-28T17:16:01Z
Lincoln,2,1,1,29113,2020-03-28T17:16:01Z
Linn,0,0,0,29115,2020-03-28T17:16:01Z
Livingston,0,0,0,29117,2020-03-28T17:16:01Z
Macon,0,0,0,29121,2020-03-28T17:16:01Z
Madison,0,0,0,29123,2020-03-28T17:16:01Z
Maries,0,0,0,29125,2020-03-28T17:16:01Z
Marion,0,0,0,29127,2020-03-28T17:16:01Z
McDonald,1,0,1,NA,2020-03-28T17:16:01Z
Mercer,0,0,0,29129,2020-03-28T17:16:01Z
Miller,0,0,0,29131,2020-03-28T17:16:01Z
Mississippi,0,0,0,29133,2020-03-28T17:16:01Z
Moniteau,2,0,2,29135,2020-03-28T17:16:01Z
Monroe,0,0,0,29137,2020-03-28T17:16:01Z
Montgomery,3,0,3,29139,2020-03-28T17:16:01Z
Morgan,0,0,0,29141,2020-03-28T17:16:01Z
New Madrid,0,0,0,29143,2020-03-28T17:16:01Z
Newton,3,3,0,29145,2020-03-28T17:16:01Z
Nodaway,0,0,0,29147,2020-03-28T17:16:01Z
Oregon,0,0,0,29149,2020-03-28T17:16:01Z
Osage,0,0,0,29151,2020-03-28T17:16:01Z
Ozark,0,0,0,29153,2020-03-28T17:16:01Z
Pemiscot,1,0,1,29155,2020-03-28T17:16:01Z
Perry,6,4,2,29157,2020-03-28T17:16:01Z
Pettis,1,0,1,29159,2020-03-28T17:16:01Z
Phelps,0,0,0,29161,2020-03-28T17:16:01Z
Pike,0,0,0,29163,2020-03-28T17:16:01Z
Platte,5,0,5,29165,2020-03-28T17:16:01Z
Polk,0,0,0,29167,2020-03-28T17:16:01Z
Pulaski,4,0,4,29169,2020-03-28T17:16:01Z
Putnam,0,0,0,29171,2020-03-28T17:16:01Z
Ralls,1,1,0,29173,2020-03-28T17:16:01Z
Randolph,1,0,1,29175,2020-03-28T17:16:01Z
Ray,1,0,1,29177,2020-03-28T17:16:01Z
Reynolds,0,0,0,29179,2020-03-28T17:16:01Z
Ripley,0,0,0,29181,2020-03-28T17:16:01Z
Saline,0,0,0,29195,2020-03-28T17:16:01Z
Schuyler,0,0,0,29197,2020-03-28T17:16:01Z
Scotland,0,0,0,29199,2020-03-28T17:16:01Z
Scott,1,0,1,29201,2020-03-28T17:16:01Z
Shannon,0,0,0,29203,2020-03-28T17:16:01Z
Shelby,1,1,0,29205,2020-03-28T17:16:01Z
St. Charles,32,5,27,29183,2020-03-28T17:16:01Z
St. Clair,0,0,0,29185,2020-03-28T17:16:01Z
St. Francois,4,1,3,29187,2020-03-28T17:16:01Z
St. Louis City,72,9,63,29510,2020-03-28T17:16:01Z
St. Louis,247,24,223,29189,2020-03-28T17:16:01Z
Ste. Genevieve,0,0,0,29186,2020-03-28T17:16:01Z
Stoddard,1,0,1,29207,2020-03-28T17:16:01Z
Stone,0,0,0,29209,2020-03-28T17:16:01Z
Sullivan,0,0,0,29211,2020-03-28T17:16:01Z
Taney,1,0,1,29213,2020-03-28T17:16:01Z
Texas,1,0,1,29215,2020-03-28T17:16:01Z
Vernon,0,0,0,29217,2020-03-28T17:16:01Z
Warren,0,0,0,29219,2020-03-28T17:16:01Z
Washington,0,0,0,29221,2020-03-28T17:16:01Z
Wayne,0,0,0,29223,2020-03-28T17:16:01Z
Webster,0,0,0,29225,2020-03-28T17:16:01Z
Worth,0,0,0,29227,2020-03-28T17:16:01Z
Wright,1,0,1,29229,2020-03-28T17:16:01Z
TBD,4,0,4,NA,2020-03-28T17:16:01Z
Adair,1,0,1,29001,2020-03-28T13:16:01Z
Andrew,0,0,0,29003,2020-03-28T13:16:01Z
Atchison,1,1,0,29005,2020-03-28T13:16:01Z
Audrain,0,0,0,29007,2020-03-28T13:16:01Z
Barry,0,0,0,29009,2020-03-28T13:16:01Z
Barton,0,0,0,29011,2020-03-28T13:16:01Z
Bates,1,0,1,29013,2020-03-28T13:16:01Z
Benton,1,0,1,29015,2020-03-28T13:16:01Z
Bollinger,1,0,1,29017,2020-03-28T13:16:01Z
Boone,37,1,36,29019,2020-03-28T13:16:01Z
Buchanan,2,0,2,29021,2020-03-28T13:16:01Z
Butler,0,0,0,29023,2020-03-28T13:16:01Z
Caldwell,0,0,0,29025,2020-03-28T13:16:01Z
Callaway,3,0,3,29027,2020-03-28T13:16:01Z
Camden,1,1,0,29029,2020-03-28T13:16:01Z
Cape Girardeau,5,0,5,29031,2020-03-28T13:16:01Z
Carroll,0,0,0,29033,2020-03-28T13:16:01Z
Carter,1,1,0,29035,2020-03-28T13:16:01Z
Cass,8,2,6,29037,2020-03-28T13:16:01Z
Cedar,0,0,0,29039,2020-03-28T13:16:01Z
Chariton,1,0,1,29041,2020-03-28T13:16:01Z
Christian,3,3,0,29043,2020-03-28T13:16:01Z
Clark,0,0,0,29045,2020-03-28T13:16:01Z
Clay,9,0,9,29047,2020-03-28T13:16:01Z
Clinton,1,0,1,29049,2020-03-28T13:16:01Z
Cole,10,3,7,29051,2020-03-28T13:16:01Z
Cooper,1,0,1,29053,2020-03-28T13:16:01Z
Crawford,0,0,0,29055,2020-03-28T13:16:01Z
Dade,0,0,0,29057,2020-03-28T13:16:01Z
Dallas,0,0,0,29059,2020-03-28T13:16:01Z
Daviess,0,0,0,29061,2020-03-28T13:16:01Z
DeKalb,0,0,0,NA,2020-03-28T13:16:01Z
Dent,0,0,0,29065,2020-03-28T13:16:01Z
Douglas,0,0,0,29067,2020-03-28T13:16:01Z
Dunklin,3,0,3,29069,2020-03-28T13:16:01Z
Franklin,4,0,4,29071,2020-03-28T13:16:01Z
Gasconade,0,0,0,29073,2020-03-28T13:16:01Z
Gentry,0,0,0,29075,2020-03-28T13:16:01Z
Greene,31,18,13,29077,2020-03-28T13:16:01Z
Grundy,0,0,0,29079,2020-03-28T13:16:01Z
Harrison,0,0,0,29081,2020-03-28T13:16:01Z
Henry,1,1,0,29083,2020-03-28T13:16:01Z
Hickory,0,0,0,29085,2020-03-28T13:16:01Z
Holt,0,0,0,29087,2020-03-28T13:16:01Z
Howard,0,0,0,29089,2020-03-28T13:16:01Z
Howell,0,0,0,29091,2020-03-28T13:16:01Z
Iron,0,0,0,29093,2020-03-28T13:16:01Z
Jackson,41,5,36,29095,2020-03-28T13:16:01Z
Jasper,1,1,0,29097,2020-03-28T13:16:01Z
Jefferson,15,2,13,29099,2020-03-28T13:16:01Z
Johnson,8,1,7,29101,2020-03-28T13:16:01Z
Joplin,1,0,1,NA,2020-03-28T13:16:01Z
Kansas City,78,1,77,NA,2020-03-28T13:16:01Z
Knox,0,0,0,29103,2020-03-28T13:16:01Z
Laclede,0,0,0,29105,2020-03-28T13:16:01Z
Lafayette,4,0,4,29107,2020-03-28T13:16:01Z
Lawrence,0,0,0,29109,2020-03-28T13:16:01Z
Lewis,0,0,0,29111,2020-03-28T13:16:01Z
Lincoln,2,1,1,29113,2020-03-28T13:16:01Z
Linn,0,0,0,29115,2020-03-28T13:16:01Z
Livingston,0,0,0,29117,2020-03-28T13:16:01Z
Macon,0,0,0,29121,2020-03-28T13:16:01Z
Madison,0,0,0,29123,2020-03-28T13:16:01Z
Maries,0,0,0,29125,2020-03-28T13:16:01Z
Marion,0,0,0,29127,2020-03-28T13:16:01Z
McDonald,1,0,1,NA,2020-03-28T13:16:01Z
Mercer,0,0,0,29129,2020-03-28T13:16:01Z
Miller,0,0,0,29131,2020-03-28T13:16:01Z
Mississippi,0,0,0,29133,2020-03-28T13:16:01Z
Moniteau,2,0,2,29135,2020-03-28T13:16:01Z
Monroe,0,0,0,29137,2020-03-28T13:16:01Z
Montgomery,3,0,3,29139,2020-03-28T13:16:01Z
Morgan,0,0,0,29141,2020-03-28T13:16:01Z
New Madrid,0,0,0,29143,2020-03-28T13:16:01Z
Newton,3,3,0,29145,2020-03-28T13:16:01Z
Nodaway,0,0,0,29147,2020-03-28T13:16:01Z
Oregon,0,0,0,29149,2020-03-28T13:16:01Z
Osage,0,0,0,29151,2020-03-28T13:16:01Z
Ozark,0,0,0,29153,2020-03-28T13:16:01Z
Pemiscot,1,0,1,29155,2020-03-28T13:16:01Z
Perry,6,4,2,29157,2020-03-28T13:16:01Z
Pettis,1,0,1,29159,2020-03-28T13:16:01Z
Phelps,0,0,0,29161,2020-03-28T13:16:01Z
Pike,0,0,0,29163,2020-03-28T13:16:01Z
Platte,5,0,5,29165,2020-03-28T13:16:01Z
Polk,0,0,0,29167,2020-03-28T13:16:01Z
Pulaski,4,0,4,29169,2020-03-28T13:16:01Z
Putnam,0,0,0,29171,2020-03-28T13:16:01Z
Ralls,1,1,0,29173,2020-03-28T13:16:01Z
Randolph,1,0,1,29175,2020-03-28T13:16:01Z
Ray,1,0,1,29177,2020-03-28T13:16:01Z
Reynolds,0,0,0,29179,2020-03-28T13:16:01Z
Ripley,0,0,0,29181,2020-03-28T13:16:01Z
Saline,0,0,0,29195,2020-03-28T13:16:01Z
Schuyler,0,0,0,29197,2020-03-28T13:16:01Z
Scotland,0,0,0,29199,2020-03-28T13:16:01Z
Scott,1,0,1,29201,2020-03-28T13:16:01Z
Shannon,0,0,0,29203,2020-03-28T13:16:01Z
Shelby,1,1,0,29205,2020-03-28T13:16:01Z
St. Charles,32,5,27,29183,2020-03-28T13:16:01Z
St. Clair,0,0,0,29185,2020-03-28T13:16:01Z
St. Francois,4,1,3,29187,2020-03-28T13:16:01Z
St. Louis City,72,9,63,29510,2020-03-28T13:16:01Z
St. Louis,247,24,223,29189,2020-03-28T13:16:01Z
Ste. Genevieve,0,0,0,29186,2020-03-28T13:16:01Z
Stoddard,1,0,1,29207,2020-03-28T13:16:01Z
Stone,0,0,0,29209,2020-03-28T13:16:01Z
Sullivan,0,0,0,29211,2020-03-28T13:16:01Z
Taney,1,0,1,29213,2020-03-28T13:16:01Z
Texas,1,0,1,29215,2020-03-28T13:16:01Z
Vernon,0,0,0,29217,2020-03-28T13:16:01Z
Warren,0,0,0,29219,2020-03-28T13:16:01Z
Washington,0,0,0,29221,2020-03-28T13:16:01Z
Wayne,0,0,0,29223,2020-03-28T13:16:01Z
Webster,0,0,0,29225,2020-03-28T13:16:01Z
Worth,0,0,0,29227,2020-03-28T13:16:01Z
Wright,1,0,1,29229,2020-03-28T13:16:01Z
TBD,4,0,4,NA,2020-03-28T13:16:01Z
Adair,1,0,1,29001,2020-03-28T01:16:02Z
Andrew,0,0,0,29003,2020-03-28T01:16:02Z
Atchison,1,1,0,29005,2020-03-28T01:16:02Z
Audrain,0,0,0,29007,2020-03-28T01:16:02Z
Barry,0,0,0,29009,2020-03-28T01:16:02Z
Barton,0,0,0,29011,2020-03-28T01:16:02Z
Bates,1,0,1,29013,2020-03-28T01:16:02Z
Benton,1,0,1,29015,2020-03-28T01:16:02Z
Bollinger,1,0,1,29017,2020-03-28T01:16:02Z
Boone,37,1,36,29019,2020-03-28T01:16:02Z
Buchanan,2,0,2,29021,2020-03-28T01:16:02Z
Butler,0,0,0,29023,2020-03-28T01:16:02Z
Caldwell,0,0,0,29025,2020-03-28T01:16:02Z
Callaway,3,0,3,29027,2020-03-28T01:16:02Z
Camden,1,1,0,29029,2020-03-28T01:16:02Z
Cape Girardeau,5,0,5,29031,2020-03-28T01:16:02Z
Carroll,0,0,0,29033,2020-03-28T01:16:02Z
Carter,1,1,0,29035,2020-03-28T01:16:02Z
Cass,8,2,6,29037,2020-03-28T01:16:02Z
Cedar,0,0,0,29039,2020-03-28T01:16:02Z
Chariton,1,0,1,29041,2020-03-28T01:16:02Z
Christian,3,3,0,29043,2020-03-28T01:16:02Z
Clark,0,0,0,29045,2020-03-28T01:16:02Z
Clay,9,0,9,29047,2020-03-28T01:16:02Z
Clinton,1,0,1,29049,2020-03-28T01:16:02Z
Cole,10,3,7,29051,2020-03-28T01:16:02Z
Cooper,1,0,1,29053,2020-03-28T01:16:02Z
Crawford,0,0,0,29055,2020-03-28T01:16:02Z
Dade,0,0,0,29057,2020-03-28T01:16:02Z
Dallas,0,0,0,29059,2020-03-28T01:16:02Z
Daviess,0,0,0,29061,2020-03-28T01:16:02Z
DeKalb,0,0,0,NA,2020-03-28T01:16:02Z
Dent,0,0,0,29065,2020-03-28T01:16:02Z
Douglas,0,0,0,29067,2020-03-28T01:16:02Z
Dunklin,3,0,3,29069,2020-03-28T01:16:02Z
Franklin,4,0,4,29071,2020-03-28T01:16:02Z
Gasconade,0,0,0,29073,2020-03-28T01:16:02Z
Gentry,0,0,0,29075,2020-03-28T01:16:02Z
Greene,31,18,13,29077,2020-03-28T01:16:02Z
Grundy,0,0,0,29079,2020-03-28T01:16:02Z
Harrison,0,0,0,29081,2020-03-28T01:16:02Z
Henry,1,1,0,29083,2020-03-28T01:16:02Z
Hickory,0,0,0,29085,2020-03-28T01:16:02Z
Holt,0,0,0,29087,2020-03-28T01:16:02Z
Howard,0,0,0,29089,2020-03-28T01:16:02Z
Howell,0,0,0,29091,2020-03-28T01:16:02Z
Iron,0,0,0,29093,2020-03-28T01:16:02Z
Jackson,41,5,36,29095,2020-03-28T01:16:02Z
Jasper,1,1,0,29097,2020-03-28T01:16:02Z
Jefferson,15,2,13,29099,2020-03-28T01:16:02Z
Johnson,8,1,7,29101,2020-03-28T01:16:02Z
Joplin,1,0,1,NA,2020-03-28T01:16:02Z
Kansas City,78,1,77,NA,2020-03-28T01:16:02Z
Knox,0,0,0,29103,2020-03-28T01:16:02Z
Laclede,0,0,0,29105,2020-03-28T01:16:02Z
Lafayette,4,0,4,29107,2020-03-28T01:16:02Z
Lawrence,0,0,0,29109,2020-03-28T01:16:02Z
Lewis,0,0,0,29111,2020-03-28T01:16:02Z
Lincoln,2,1,1,29113,2020-03-28T01:16:02Z
Linn,0,0,0,29115,2020-03-28T01:16:02Z
Livingston,0,0,0,29117,2020-03-28T01:16:02Z
Macon,0,0,0,29121,2020-03-28T01:16:02Z
Madison,0,0,0,29123,2020-03-28T01:16:02Z
Maries,0,0,0,29125,2020-03-28T01:16:02Z
Marion,0,0,0,29127,2020-03-28T01:16:02Z
McDonald,1,0,1,NA,2020-03-28T01:16:02Z
Mercer,0,0,0,29129,2020-03-28T01:16:02Z
Miller,0,0,0,29131,2020-03-28T01:16:02Z
Mississippi,0,0,0,29133,2020-03-28T01:16:02Z
Moniteau,2,0,2,29135,2020-03-28T01:16:02Z
Monroe,0,0,0,29137,2020-03-28T01:16:02Z
Montgomery,3,0,3,29139,2020-03-28T01:16:02Z
Morgan,0,0,0,29141,2020-03-28T01:16:02Z
New Madrid,0,0,0,29143,2020-03-28T01:16:02Z
Newton,3,3,0,29145,2020-03-28T01:16:02Z
Nodaway,0,0,0,29147,2020-03-28T01:16:02Z
Oregon,0,0,0,29149,2020-03-28T01:16:02Z
Osage,0,0,0,29151,2020-03-28T01:16:02Z
Ozark,0,0,0,29153,2020-03-28T01:16:02Z
Pemiscot,1,0,1,29155,2020-03-28T01:16:02Z
Perry,6,4,2,29157,2020-03-28T01:16:02Z
Pettis,1,0,1,29159,2020-03-28T01:16:02Z
Phelps,0,0,0,29161,2020-03-28T01:16:02Z
Pike,0,0,0,29163,2020-03-28T01:16:02Z
Platte,5,0,5,29165,2020-03-28T01:16:02Z
Polk,0,0,0,29167,2020-03-28T01:16:02Z
Pulaski,4,0,4,29169,2020-03-28T01:16:02Z
Putnam,0,0,0,29171,2020-03-28T01:16:02Z
Ralls,1,1,0,29173,2020-03-28T01:16:02Z
Randolph,1,0,1,29175,2020-03-28T01:16:02Z
Ray,1,0,1,29177,2020-03-28T01:16:02Z
Reynolds,0,0,0,29179,2020-03-28T01:16:02Z
Ripley,0,0,0,29181,2020-03-28T01:16:02Z
Saline,0,0,0,29195,2020-03-28T01:16:02Z
Schuyler,0,0,0,29197,2020-03-28T01:16:02Z
Scotland,0,0,0,29199,2020-03-28T01:16:02Z
Scott,1,0,1,29201,2020-03-28T01:16:02Z
Shannon,0,0,0,29203,2020-03-28T01:16:02Z
Shelby,1,1,0,29205,2020-03-28T01:16:02Z
St. Charles,32,5,27,29183,2020-03-28T01:16:02Z
St. Clair,0,0,0,29185,2020-03-28T01:16:02Z
St. Francois,4,1,3,29187,2020-03-28T01:16:02Z
St. Louis City,72,9,63,29510,2020-03-28T01:16:02Z
St. Louis,247,24,223,29189,2020-03-28T01:16:02Z
Ste. Genevieve,0,0,0,29186,2020-03-28T01:16:02Z
Stoddard,1,0,1,29207,2020-03-28T01:16:02Z
Stone,0,0,0,29209,2020-03-28T01:16:02Z
Sullivan,0,0,0,29211,2020-03-28T01:16:02Z
Taney,1,0,1,29213,2020-03-28T01:16:02Z
Texas,1,0,1,29215,2020-03-28T01:16:02Z
Vernon,0,0,0,29217,2020-03-28T01:16:02Z
Warren,0,0,0,29219,2020-03-28T01:16:02Z
Washington,0,0,0,29221,2020-03-28T01:16:02Z
Wayne,0,0,0,29223,2020-03-28T01:16:02Z
Webster,0,0,0,29225,2020-03-28T01:16:02Z
Worth,0,0,0,29227,2020-03-28T01:16:02Z
Wright,1,0,1,29229,2020-03-28T01:16:02Z
TBD,4,0,4,NA,2020-03-28T01:16:02Z
Adair,1,0,1,29001,2020-03-27T21:16:01Z
Andrew,0,0,0,29003,2020-03-27T21:16:01Z
Atchison,1,1,0,29005,2020-03-27T21:16:01Z
Audrain,0,0,0,29007,2020-03-27T21:16:01Z
Barry,0,0,0,29009,2020-03-27T21:16:01Z
Barton,0,0,0,29011,2020-03-27T21:16:01Z
Bates,1,0,1,29013,2020-03-27T21:16:01Z
Benton,1,0,1,29015,2020-03-27T21:16:01Z
Bollinger,1,0,1,29017,2020-03-27T21:16:01Z
Boone,37,1,36,29019,2020-03-27T21:16:01Z
Buchanan,2,0,2,29021,2020-03-27T21:16:01Z
Butler,0,0,0,29023,2020-03-27T21:16:01Z
Caldwell,0,0,0,29025,2020-03-27T21:16:01Z
Callaway,3,0,3,29027,2020-03-27T21:16:01Z
Camden,1,1,0,29029,2020-03-27T21:16:01Z
Cape Girardeau,5,0,5,29031,2020-03-27T21:16:01Z
Carroll,0,0,0,29033,2020-03-27T21:16:01Z
Carter,1,1,0,29035,2020-03-27T21:16:01Z
Cass,8,2,6,29037,2020-03-27T21:16:01Z
Cedar,0,0,0,29039,2020-03-27T21:16:01Z
Chariton,1,0,1,29041,2020-03-27T21:16:01Z
Christian,3,3,0,29043,2020-03-27T21:16:01Z
Clark,0,0,0,29045,2020-03-27T21:16:01Z
Clay,9,0,9,29047,2020-03-27T21:16:01Z
Clinton,1,0,1,29049,2020-03-27T21:16:01Z
Cole,10,3,7,29051,2020-03-27T21:16:01Z
Cooper,1,0,1,29053,2020-03-27T21:16:01Z
Crawford,0,0,0,29055,2020-03-27T21:16:01Z
Dade,0,0,0,29057,2020-03-27T21:16:01Z
Dallas,0,0,0,29059,2020-03-27T21:16:01Z
Daviess,0,0,0,29061,2020-03-27T21:16:01Z
DeKalb,0,0,0,NA,2020-03-27T21:16:01Z
Dent,0,0,0,29065,2020-03-27T21:16:01Z
Douglas,0,0,0,29067,2020-03-27T21:16:01Z
Dunklin,3,0,3,29069,2020-03-27T21:16:01Z
Franklin,4,0,4,29071,2020-03-27T21:16:01Z
Gasconade,0,0,0,29073,2020-03-27T21:16:01Z
Gentry,0,0,0,29075,2020-03-27T21:16:01Z
Greene,31,18,13,29077,2020-03-27T21:16:01Z
Grundy,0,0,0,29079,2020-03-27T21:16:01Z
Harrison,0,0,0,29081,2020-03-27T21:16:01Z
Henry,1,1,0,29083,2020-03-27T21:16:01Z
Hickory,0,0,0,29085,2020-03-27T21:16:01Z
Holt,0,0,0,29087,2020-03-27T21:16:01Z
Howard,0,0,0,29089,2020-03-27T21:16:01Z
Howell,0,0,0,29091,2020-03-27T21:16:01Z
Iron,0,0,0,29093,2020-03-27T21:16:01Z
Jackson,41,5,36,29095,2020-03-27T21:16:01Z
Jasper,2,1,1,29097,2020-03-27T21:16:01Z
Jefferson,15,2,13,29099,2020-03-27T21:16:01Z
Johnson,8,1,7,29101,2020-03-27T21:16:01Z
Kansas City,78,1,77,NA,2020-03-27T21:16:01Z
Knox,0,0,0,29103,2020-03-27T21:16:01Z
Laclede,0,0,0,29105,2020-03-27T21:16:01Z
Lafayette,4,0,4,29107,2020-03-27T21:16:01Z
Lawrence,0,0,0,29109,2020-03-27T21:16:01Z
Lewis,0,0,0,29111,2020-03-27T21:16:01Z
Lincoln,2,1,1,29113,2020-03-27T21:16:01Z
Linn,0,0,0,29115,2020-03-27T21:16:01Z
Livingston,0,0,0,29117,2020-03-27T21:16:01Z
Macon,0,0,0,29121,2020-03-27T21:16:01Z
Madison,0,0,0,29123,2020-03-27T21:16:01Z
Maries,0,0,0,29125,2020-03-27T21:16:01Z
Marion,0,0,0,29127,2020-03-27T21:16:01Z
McDonald,1,0,1,NA,2020-03-27T21:16:01Z
Mercer,0,0,0,29129,2020-03-27T21:16:01Z
Miller,0,0,0,29131,2020-03-27T21:16:01Z
Mississippi,0,0,0,29133,2020-03-27T21:16:01Z
Moniteau,2,0,2,29135,2020-03-27T21:16:01Z
Monroe,0,0,0,29137,2020-03-27T21:16:01Z
Montgomery,3,0,3,29139,2020-03-27T21:16:01Z
Morgan,0,0,0,29141,2020-03-27T21:16:01Z
New Madrid,0,0,0,29143,2020-03-27T21:16:01Z
Newton,3,3,0,29145,2020-03-27T21:16:01Z
Nodaway,0,0,0,29147,2020-03-27T21:16:01Z
Oregon,0,0,0,29149,2020-03-27T21:16:01Z
Osage,0,0,0,29151,2020-03-27T21:16:01Z
Ozark,0,0,0,29153,2020-03-27T21:16:01Z
Pemiscot,1,0,1,29155,2020-03-27T21:16:01Z
Perry,6,4,2,29157,2020-03-27T21:16:01Z
Pettis,1,0,1,29159,2020-03-27T21:16:01Z
Phelps,0,0,0,29161,2020-03-27T21:16:01Z
Pike,0,0,0,29163,2020-03-27T21:16:01Z
Platte,5,0,5,29165,2020-03-27T21:16:01Z
Polk,0,0,0,29167,2020-03-27T21:16:01Z
Pulaski,4,0,4,29169,2020-03-27T21:16:01Z
Putnam,0,0,0,29171,2020-03-27T21:16:01Z
Ralls,1,1,0,29173,2020-03-27T21:16:01Z
Randolph,1,0,1,29175,2020-03-27T21:16:01Z
Ray,1,0,1,29177,2020-03-27T21:16:01Z
Reynolds,0,0,0,29179,2020-03-27T21:16:01Z
Ripley,0,0,0,29181,2020-03-27T21:16:01Z
Saline,0,0,0,29195,2020-03-27T21:16:01Z
Schuyler,0,0,0,29197,2020-03-27T21:16:01Z
Scotland,0,0,0,29199,2020-03-27T21:16:01Z
Scott,1,0,1,29201,2020-03-27T21:16:01Z
Shannon,0,0,0,29203,2020-03-27T21:16:01Z
Shelby,1,1,0,29205,2020-03-27T21:16:01Z
St. Charles,32,5,27,29183,2020-03-27T21:16:01Z
St. Clair,0,0,0,29185,2020-03-27T21:16:01Z
St. Francois,4,1,3,29187,2020-03-27T21:16:01Z
St. Louis City,72,9,63,29510,2020-03-27T21:16:01Z
St. Louis,247,24,223,29189,2020-03-27T21:16:01Z
Ste. Genevieve,0,0,0,29186,2020-03-27T21:16:01Z
Stoddard,1,0,1,29207,2020-03-27T21:16:01Z
Stone,0,0,0,29209,2020-03-27T21:16:01Z
Sullivan,0,0,0,29211,2020-03-27T21:16:01Z
Taney,1,0,1,29213,2020-03-27T21:16:01Z
Texas,1,0,1,29215,2020-03-27T21:16:01Z
Vernon,0,0,0,29217,2020-03-27T21:16:01Z
Warren,0,0,0,29219,2020-03-27T21:16:01Z
Washington,0,0,0,29221,2020-03-27T21:16:01Z
Wayne,0,0,0,29223,2020-03-27T21:16:01Z
Webster,0,0,0,29225,2020-03-27T21:16:01Z
Worth,0,0,0,29227,2020-03-27T21:16:01Z
Wright,1,0,1,29229,2020-03-27T21:16:01Z
TBD,4,0,4,NA,2020-03-27T21:16:01Z
Adair,1,0,1,29001,2020-03-27T17:16:01Z
Bates,1,0,1,29013,2020-03-27T17:16:01Z
Benton,1,0,1,29015,2020-03-27T17:16:01Z
Bollinger,1,0,1,29017,2020-03-27T17:16:01Z
Boone,25,1,24,29019,2020-03-27T17:16:01Z
Callaway,2,0,2,29027,2020-03-27T17:16:01Z
Camden,1,1,0,29029,2020-03-27T17:16:01Z
Cape Girardeau,3,0,3,29031,2020-03-27T17:16:01Z
Carter,1,1,0,29035,2020-03-27T17:16:01Z
Cass,8,2,6,29037,2020-03-27T17:16:01Z
Christian,2,2,0,29043,2020-03-27T17:16:01Z
Clay,5,0,5,29047,2020-03-27T17:16:01Z
Clinton,1,0,1,29049,2020-03-27T17:16:01Z
Cole,8,3,5,29051,2020-03-27T17:16:01Z
Cooper,1,0,1,29053,2020-03-27T17:16:01Z
Dunklin,2,0,2,29069,2020-03-27T17:16:01Z
Franklin,4,0,4,29071,2020-03-27T17:16:01Z
Greene,25,15,10,29077,2020-03-27T17:16:01Z
Henry,1,1,0,29083,2020-03-27T17:16:01Z
Jackson,31,2,29,29095,2020-03-27T17:16:01Z
Jasper,2,1,1,29097,2020-03-27T17:16:01Z
Jefferson,10,2,8,29099,2020-03-27T17:16:01Z
Johnson,8,1,7,29101,2020-03-27T17:16:01Z
Kansas City,64,1,63,NA,2020-03-27T17:16:01Z
Lafayette,2,0,2,29107,2020-03-27T17:16:01Z
McDonald,1,0,1,NA,2020-03-27T17:16:01Z
Moniteau,2,0,2,29135,2020-03-27T17:16:01Z
Montgomery,2,0,2,29139,2020-03-27T17:16:01Z
Newton,3,3,0,29145,2020-03-27T17:16:01Z
Pemiscot,1,0,1,29155,2020-03-27T17:16:01Z
Perry,4,2,2,29157,2020-03-27T17:16:01Z
Platte,5,0,5,29165,2020-03-27T17:16:01Z
Pulaski,4,0,4,29169,2020-03-27T17:16:01Z
Ralls,1,1,0,29173,2020-03-27T17:16:01Z
Randolph,1,0,1,29175,2020-03-27T17:16:01Z
Scott,1,0,1,29201,2020-03-27T17:16:01Z
Shelby,1,1,0,29205,2020-03-27T17:16:01Z
St. Charles,22,1,21,29183,2020-03-27T17:16:01Z
St. Francois,2,1,1,29187,2020-03-27T17:16:01Z
St. Louis City,57,9,48,29510,2020-03-27T17:16:01Z
St. Louis,173,20,153,29189,2020-03-27T17:16:01Z
Stoddard,1,0,1,29207,2020-03-27T17:16:01Z
Taney,1,0,1,29213,2020-03-27T17:16:01Z
TBD,10,1,9,NA,2020-03-27T17:16:01Z
Adair,1,0,1,29001,2020-03-27T13:16:01Z
Bates,1,0,1,29013,2020-03-27T13:16:01Z
Benton,1,0,1,29015,2020-03-27T13:16:01Z
Bollinger,1,0,1,29017,2020-03-27T13:16:01Z
Boone,25,1,24,29019,2020-03-27T13:16:01Z
Callaway,2,0,2,29027,2020-03-27T13:16:01Z
Camden,1,1,0,29029,2020-03-27T13:16:01Z
Cape Girardeau,3,0,3,29031,2020-03-27T13:16:01Z
Carter,1,1,0,29035,2020-03-27T13:16:01Z
Cass,8,2,6,29037,2020-03-27T13:16:01Z
Christian,2,2,0,29043,2020-03-27T13:16:01Z
Clay,5,0,5,29047,2020-03-27T13:16:01Z
Clinton,1,0,1,29049,2020-03-27T13:16:01Z
Cole,8,3,5,29051,2020-03-27T13:16:01Z
Cooper,1,0,1,29053,2020-03-27T13:16:01Z
Dunklin,2,0,2,29069,2020-03-27T13:16:01Z
Franklin,4,0,4,29071,2020-03-27T13:16:01Z
Greene,25,15,10,29077,2020-03-27T13:16:01Z
Henry,1,1,0,29083,2020-03-27T13:16:01Z
Jackson,31,2,29,29095,2020-03-27T13:16:01Z
Jasper,2,1,1,29097,2020-03-27T13:16:01Z
Jefferson,10,2,8,29099,2020-03-27T13:16:01Z
Johnson,8,1,7,29101,2020-03-27T13:16:01Z
Kansas City,64,1,63,NA,2020-03-27T13:16:01Z
Lafayette,2,0,2,29107,2020-03-27T13:16:01Z
McDonald,1,0,1,NA,2020-03-27T13:16:01Z
Moniteau,2,0,2,29135,2020-03-27T13:16:01Z
Montgomery,2,0,2,29139,2020-03-27T13:16:01Z
Newton,3,3,0,29145,2020-03-27T13:16:01Z
Pemiscot,1,0,1,29155,2020-03-27T13:16:01Z
Perry,4,2,2,29157,2020-03-27T13:16:01Z
Platte,5,0,5,29165,2020-03-27T13:16:01Z
Pulaski,4,0,4,29169,2020-03-27T13:16:01Z
Ralls,1,1,0,29173,2020-03-27T13:16:01Z
Randolph,1,0,1,29175,2020-03-27T13:16:01Z
Scott,1,0,1,29201,2020-03-27T13:16:01Z
Shelby,1,1,0,29205,2020-03-27T13:16:01Z
St. Charles,22,1,21,29183,2020-03-27T13:16:01Z
St. Francois,2,1,1,29187,2020-03-27T13:16:01Z
St. Louis City,57,9,48,29510,2020-03-27T13:16:01Z
St. Louis,173,20,153,29189,2020-03-27T13:16:01Z
Stoddard,1,0,1,29207,2020-03-27T13:16:01Z
Taney,1,0,1,29213,2020-03-27T13:16:01Z
TBD,10,1,9,NA,2020-03-27T13:16:01Z
Adair,1,0,1,29001,2020-03-27T01:16:01Z
Bates,1,0,1,29013,2020-03-27T01:16:01Z
Benton,1,0,1,29015,2020-03-27T01:16:01Z
Bollinger,1,0,1,29017,2020-03-27T01:16:01Z
Boone,25,1,24,29019,2020-03-27T01:16:01Z
Callaway,2,0,2,29027,2020-03-27T01:16:01Z
Camden,1,1,0,29029,2020-03-27T01:16:01Z
Cape Girardeau,3,0,3,29031,2020-03-27T01:16:01Z
Carter,1,1,0,29035,2020-03-27T01:16:01Z
Cass,8,2,6,29037,2020-03-27T01:16:01Z
Christian,2,2,0,29043,2020-03-27T01:16:01Z
Clay,5,0,5,29047,2020-03-27T01:16:01Z
Clinton,1,0,1,29049,2020-03-27T01:16:01Z
Cole,8,3,5,29051,2020-03-27T01:16:01Z
Cooper,1,0,1,29053,2020-03-27T01:16:01Z
Dunklin,2,0,2,29069,2020-03-27T01:16:01Z
Franklin,4,0,4,29071,2020-03-27T01:16:01Z
Greene,25,15,10,29077,2020-03-27T01:16:01Z
Henry,1,1,0,29083,2020-03-27T01:16:01Z
Jackson,31,2,29,29095,2020-03-27T01:16:01Z
Jasper,2,1,1,29097,2020-03-27T01:16:01Z
Jefferson,10,2,8,29099,2020-03-27T01:16:01Z
Johnson,8,1,7,29101,2020-03-27T01:16:01Z
Kansas City,64,1,63,NA,2020-03-27T01:16:01Z
Lafayette,2,0,2,29107,2020-03-27T01:16:01Z
McDonald,1,0,1,NA,2020-03-27T01:16:01Z
Moniteau,2,0,2,29135,2020-03-27T01:16:01Z
Montgomery,2,0,2,29139,2020-03-27T01:16:01Z
Newton,3,3,0,29145,2020-03-27T01:16:01Z
Pemiscot,1,0,1,29155,2020-03-27T01:16:01Z
Perry,4,2,2,29157,2020-03-27T01:16:01Z
Platte,5,0,5,29165,2020-03-27T01:16:01Z
Pulaski,4,0,4,29169,2020-03-27T01:16:01Z
Ralls,1,1,0,29173,2020-03-27T01:16:01Z
Randolph,1,0,1,29175,2020-03-27T01:16:01Z
Scott,1,0,1,29201,2020-03-27T01:16:01Z
Shelby,1,1,0,29205,2020-03-27T01:16:01Z
St. Charles,22,1,21,29183,2020-03-27T01:16:01Z
St. Francois,2,1,1,29187,2020-03-27T01:16:01Z
St. Louis City,57,9,48,29510,2020-03-27T01:16:01Z
St. Louis,173,20,153,29189,2020-03-27T01:16:01Z
Stoddard,1,0,1,29207,2020-03-27T01:16:01Z
Taney,1,0,1,29213,2020-03-27T01:16:01Z
TBD,10,1,9,NA,2020-03-27T01:16:01Z
Adair,1,0,1,29001,2020-03-26T21:16:01Z
Bates,1,0,1,29013,2020-03-26T21:16:01Z
Benton,1,0,1,29015,2020-03-26T21:16:01Z
Bollinger,1,0,1,29017,2020-03-26T21:16:01Z
Boone,25,1,24,29019,2020-03-26T21:16:01Z
Callaway,2,0,2,29027,2020-03-26T21:16:01Z
Camden,1,1,0,29029,2020-03-26T21:16:01Z
Cape Girardeau,3,0,3,29031,2020-03-26T21:16:01Z
Carter,1,1,0,29035,2020-03-26T21:16:01Z
Cass,8,2,6,29037,2020-03-26T21:16:01Z
Christian,2,2,0,29043,2020-03-26T21:16:01Z
Clay,5,0,5,29047,2020-03-26T21:16:01Z
Clinton,1,0,1,29049,2020-03-26T21:16:01Z
Cole,8,3,5,29051,2020-03-26T21:16:01Z
Cooper,1,0,1,29053,2020-03-26T21:16:01Z
Dunklin,2,0,2,29069,2020-03-26T21:16:01Z
Franklin,4,0,4,29071,2020-03-26T21:16:01Z
Greene,25,15,10,29077,2020-03-26T21:16:01Z
Henry,1,1,0,29083,2020-03-26T21:16:01Z
Jackson,31,2,29,29095,2020-03-26T21:16:01Z
Jasper,2,1,1,29097,2020-03-26T21:16:01Z
Jefferson,10,2,8,29099,2020-03-26T21:16:01Z
Johnson,8,1,7,29101,2020-03-26T21:16:01Z
Kansas City,64,1,63,NA,2020-03-26T21:16:01Z
Lafayette,2,0,2,29107,2020-03-26T21:16:01Z
McDonald,1,0,1,NA,2020-03-26T21:16:01Z
Moniteau,2,0,2,29135,2020-03-26T21:16:01Z
Montgomery,2,0,2,29139,2020-03-26T21:16:01Z
Newton,3,3,0,29145,2020-03-26T21:16:01Z
Pemiscot,1,0,1,29155,2020-03-26T21:16:01Z
Perry,4,2,2,29157,2020-03-26T21:16:01Z
Platte,5,0,5,29165,2020-03-26T21:16:01Z
Pulaski,4,0,4,29169,2020-03-26T21:16:01Z
Ralls,1,1,0,29173,2020-03-26T21:16:01Z
Randolph,1,0,1,29175,2020-03-26T21:16:01Z
Scott,1,0,1,29201,2020-03-26T21:16:01Z
Shelby,1,1,0,29205,2020-03-26T21:16:01Z
St. Charles,22,1,21,29183,2020-03-26T21:16:01Z
St. Francois,2,1,1,29187,2020-03-26T21:16:01Z
St. Louis City,57,9,48,29510,2020-03-26T21:16:01Z
St. Louis,173,20,153,29189,2020-03-26T21:16:01Z
Stoddard,1,0,1,29207,2020-03-26T21:16:01Z
Taney,1,0,1,29213,2020-03-26T21:16:01Z
TBD,10,1,9,NA,2020-03-26T21:16:01Z
Adair,1,0,1,29001,2020-03-26T17:16:01Z
Bates,1,0,1,29013,2020-03-26T17:16:01Z
Boone,20,1,19,29019,2020-03-26T17:16:01Z
Callaway,2,0,2,29027,2020-03-26T17:16:01Z
Camden,1,1,0,29029,2020-03-26T17:16:01Z
Cape Girardeau,3,0,3,29031,2020-03-26T17:16:01Z
Cass,8,2,6,29037,2020-03-26T17:16:01Z
Christian,1,1,0,29043,2020-03-26T17:16:01Z
Clay,2,0,2,29047,2020-03-26T17:16:01Z
Clinton,1,0,1,29049,2020-03-26T17:16:01Z
Cole,6,3,3,29051,2020-03-26T17:16:01Z
Cooper,1,0,1,29053,2020-03-26T17:16:01Z
Dunklin,1,0,1,29069,2020-03-26T17:16:01Z
Franklin,3,0,3,29071,2020-03-26T17:16:01Z
Greene,23,15,8,29077,2020-03-26T17:16:01Z
Henry,1,1,0,29083,2020-03-26T17:16:01Z
Jackson,17,2,15,29095,2020-03-26T17:16:01Z
Jasper,2,1,1,29097,2020-03-26T17:16:01Z
Jefferson,5,1,4,29099,2020-03-26T17:16:01Z
Johnson,2,1,1,29101,2020-03-26T17:16:01Z
Kansas City,43,1,42,NA,2020-03-26T17:16:01Z
Lafayette,2,0,2,29107,2020-03-26T17:16:01Z
McDonald,1,0,1,NA,2020-03-26T17:16:01Z
Moniteau,2,0,2,29135,2020-03-26T17:16:01Z
Montgomery,1,0,1,29139,2020-03-26T17:16:01Z
Newton,1,1,0,29145,2020-03-26T17:16:01Z
Pemiscot,1,0,1,29155,2020-03-26T17:16:01Z
Perry,2,1,1,29157,2020-03-26T17:16:01Z
Platte,2,0,2,29165,2020-03-26T17:16:01Z
Pulaski,4,0,4,29169,2020-03-26T17:16:01Z
Ralls,1,1,0,29173,2020-03-26T17:16:01Z
Randolph,1,0,1,29175,2020-03-26T17:16:01Z
Scott,1,0,1,29201,2020-03-26T17:16:01Z
Shelby,1,1,0,29205,2020-03-26T17:16:01Z
St. Charles,12,1,11,29183,2020-03-26T17:16:01Z
St. Francois,2,1,1,29187,2020-03-26T17:16:01Z
St. Louis City,44,9,35,29510,2020-03-26T17:16:01Z
St. Louis,129,17,112,29189,2020-03-26T17:16:01Z
Taney,1,0,1,29213,2020-03-26T17:16:01Z
TBD,4,0,4,NA,2020-03-26T17:16:01Z
Adair,1,0,1,29001,2020-03-26T13:16:02Z
Bates,1,0,1,29013,2020-03-26T13:16:02Z
Boone,20,1,19,29019,2020-03-26T13:16:02Z
Callaway,2,0,2,29027,2020-03-26T13:16:02Z
Camden,1,1,0,29029,2020-03-26T13:16:02Z
Cape Girardeau,3,0,3,29031,2020-03-26T13:16:02Z
Cass,8,2,6,29037,2020-03-26T13:16:02Z
Christian,1,1,0,29043,2020-03-26T13:16:02Z
Clay,2,0,2,29047,2020-03-26T13:16:02Z
Clinton,1,0,1,29049,2020-03-26T13:16:02Z
Cole,6,3,3,29051,2020-03-26T13:16:02Z
Cooper,1,0,1,29053,2020-03-26T13:16:02Z
Dunklin,1,0,1,29069,2020-03-26T13:16:02Z
Franklin,3,0,3,29071,2020-03-26T13:16:02Z
Greene,23,15,8,29077,2020-03-26T13:16:02Z
Henry,1,1,0,29083,2020-03-26T13:16:02Z
Jackson,17,2,15,29095,2020-03-26T13:16:02Z
Jasper,2,1,1,29097,2020-03-26T13:16:02Z
Jefferson,5,1,4,29099,2020-03-26T13:16:02Z
Johnson,2,1,1,29101,2020-03-26T13:16:02Z
Kansas City,43,1,42,NA,2020-03-26T13:16:02Z
Lafayette,2,0,2,29107,2020-03-26T13:16:02Z
McDonald,1,0,1,NA,2020-03-26T13:16:02Z
Moniteau,2,0,2,29135,2020-03-26T13:16:02Z
Montgomery,1,0,1,29139,2020-03-26T13:16:02Z
Newton,1,1,0,29145,2020-03-26T13:16:02Z
Pemiscot,1,0,1,29155,2020-03-26T13:16:02Z
Perry,2,1,1,29157,2020-03-26T13:16:02Z
Platte,2,0,2,29165,2020-03-26T13:16:02Z
Pulaski,4,0,4,29169,2020-03-26T13:16:02Z
Ralls,1,1,0,29173,2020-03-26T13:16:02Z
Randolph,1,0,1,29175,2020-03-26T13:16:02Z
Scott,1,0,1,29201,2020-03-26T13:16:02Z
Shelby,1,1,0,29205,2020-03-26T13:16:02Z
St. Charles,12,1,11,29183,2020-03-26T13:16:02Z
St. Francois,2,1,1,29187,2020-03-26T13:16:02Z
St. Louis City,44,9,35,29510,2020-03-26T13:16:02Z
St. Louis,129,17,112,29189,2020-03-26T13:16:02Z
Taney,1,0,1,29213,2020-03-26T13:16:02Z
TBD,4,0,4,NA,2020-03-26T13:16:02Z
Adair,1,0,1,29001,2020-03-26T01:16:01Z
Bates,1,0,1,29013,2020-03-26T01:16:01Z
Boone,20,1,19,29019,2020-03-26T01:16:01Z
Callaway,2,0,2,29027,2020-03-26T01:16:01Z
Camden,1,1,0,29029,2020-03-26T01:16:01Z
Cape Girardeau,3,0,3,29031,2020-03-26T01:16:01Z
Cass,8,2,6,29037,2020-03-26T01:16:01Z
Christian,1,1,0,29043,2020-03-26T01:16:01Z
Clay,2,0,2,29047,2020-03-26T01:16:01Z
Clinton,1,0,1,29049,2020-03-26T01:16:01Z
Cole,6,3,3,29051,2020-03-26T01:16:01Z
Cooper,1,0,1,29053,2020-03-26T01:16:01Z
Dunklin,1,0,1,29069,2020-03-26T01:16:01Z
Franklin,3,0,3,29071,2020-03-26T01:16:01Z
Greene,23,15,8,29077,2020-03-26T01:16:01Z
Henry,1,1,0,29083,2020-03-26T01:16:01Z
Jackson,17,2,15,29095,2020-03-26T01:16:01Z
Jasper,2,1,1,29097,2020-03-26T01:16:01Z
Jefferson,5,1,4,29099,2020-03-26T01:16:01Z
Johnson,2,1,1,29101,2020-03-26T01:16:01Z
Kansas City,43,1,42,NA,2020-03-26T01:16:01Z
Lafayette,2,0,2,29107,2020-03-26T01:16:01Z
McDonald,1,0,1,NA,2020-03-26T01:16:01Z
Moniteau,2,0,2,29135,2020-03-26T01:16:01Z
Montgomery,1,0,1,29139,2020-03-26T01:16:01Z
Newton,1,1,0,29145,2020-03-26T01:16:01Z
Pemiscot,1,0,1,29155,2020-03-26T01:16:01Z
Perry,2,1,1,29157,2020-03-26T01:16:01Z
Platte,2,0,2,29165,2020-03-26T01:16:01Z
Pulaski,4,0,4,29169,2020-03-26T01:16:01Z
Ralls,1,1,0,29173,2020-03-26T01:16:01Z
Randolph,1,0,1,29175,2020-03-26T01:16:01Z
Scott,1,0,1,29201,2020-03-26T01:16:01Z
Shelby,1,1,0,29205,2020-03-26T01:16:01Z
St. Charles,12,1,11,29183,2020-03-26T01:16:01Z
St. Francois,2,1,1,29187,2020-03-26T01:16:01Z
St. Louis City,44,9,35,29510,2020-03-26T01:16:01Z
St. Louis,129,17,112,29189,2020-03-26T01:16:01Z
Taney,1,0,1,29213,2020-03-26T01:16:01Z
TBD,4,0,4,NA,2020-03-26T01:16:01Z
Adair,1,0,1,29001,2020-03-25T21:16:01Z
Bates,1,0,1,29013,2020-03-25T21:16:01Z
Boone,20,1,19,29019,2020-03-25T21:16:01Z
Callaway,2,0,2,29027,2020-03-25T21:16:01Z
Camden,1,1,0,29029,2020-03-25T21:16:01Z
Cape Girardeau,3,0,3,29031,2020-03-25T21:16:01Z
Cass,8,2,6,29037,2020-03-25T21:16:01Z
Christian,1,1,0,29043,2020-03-25T21:16:01Z
Clay,2,0,2,29047,2020-03-25T21:16:01Z
Clinton,1,0,1,29049,2020-03-25T21:16:01Z
Cole,6,3,3,29051,2020-03-25T21:16:01Z
Cooper,1,0,1,29053,2020-03-25T21:16:01Z
Dunklin,1,0,1,29069,2020-03-25T21:16:01Z
Franklin,3,0,3,29071,2020-03-25T21:16:01Z
Greene,23,15,8,29077,2020-03-25T21:16:01Z
Henry,1,1,0,29083,2020-03-25T21:16:01Z
Jackson,17,2,15,29095,2020-03-25T21:16:01Z
Jasper,2,1,1,29097,2020-03-25T21:16:01Z
Jefferson,5,1,4,29099,2020-03-25T21:16:01Z
Johnson,2,1,1,29101,2020-03-25T21:16:01Z
Kansas City,43,1,42,NA,2020-03-25T21:16:01Z
Lafayette,2,0,2,29107,2020-03-25T21:16:01Z
McDonald,1,0,1,NA,2020-03-25T21:16:01Z
Moniteau,2,0,2,29135,2020-03-25T21:16:01Z
Montgomery,1,0,1,29139,2020-03-25T21:16:01Z
Newton,1,1,0,29145,2020-03-25T21:16:01Z
Pemiscot,1,0,1,29155,2020-03-25T21:16:01Z
Perry,2,1,1,29157,2020-03-25T21:16:01Z
Platte,2,0,2,29165,2020-03-25T21:16:01Z
Pulaski,4,0,4,29169,2020-03-25T21:16:01Z
Ralls,1,1,0,29173,2020-03-25T21:16:01Z
Randolph,1,0,1,29175,2020-03-25T21:16:01Z
Scott,1,0,1,29201,2020-03-25T21:16:01Z
Shelby,1,1,0,29205,2020-03-25T21:16:01Z
St. Charles,12,1,11,29183,2020-03-25T21:16:01Z
St. Francois,2,1,1,29187,2020-03-25T21:16:01Z
St. Louis City,44,9,35,29510,2020-03-25T21:16:01Z
St. Louis,129,17,112,29189,2020-03-25T21:16:01Z
Taney,1,0,1,29213,2020-03-25T21:16:01Z
TBD,4,0,4,NA,2020-03-25T21:16:01Z
Adair,1,0,1,29001,2020-03-25T17:16:01Z
Bates,1,0,1,29013,2020-03-25T17:16:01Z
Boone,20,1,19,29019,2020-03-25T17:16:01Z
Callaway,2,0,2,29027,2020-03-25T17:16:01Z
Camden,1,1,0,29029,2020-03-25T17:16:01Z
Cass,6,2,4,29037,2020-03-25T17:16:01Z
Christian,1,1,0,29043,2020-03-25T17:16:01Z
Clay,2,0,2,29047,2020-03-25T17:16:01Z
Clinton,1,0,1,29049,2020-03-25T17:16:01Z
Cole,5,3,2,29051,2020-03-25T17:16:01Z
Dunklin,1,0,1,29069,2020-03-25T17:16:01Z
Franklin,1,0,1,29071,2020-03-25T17:16:01Z
Greene,19,12,7,29077,2020-03-25T17:16:01Z
Henry,1,1,0,29083,2020-03-25T17:16:01Z
Jackson,14,2,12,29095,2020-03-25T17:16:01Z
Jasper,1,1,0,29097,2020-03-25T17:16:01Z
Jefferson,4,1,3,29099,2020-03-25T17:16:01Z
Johnson,1,1,0,29101,2020-03-25T17:16:01Z
Kansas City,21,0,21,NA,2020-03-25T17:16:01Z
Lafayette,1,0,1,29107,2020-03-25T17:16:01Z
Moniteau,1,0,1,29135,2020-03-25T17:16:01Z
Pemiscot,1,0,1,29155,2020-03-25T17:16:01Z
Perry,2,1,1,29157,2020-03-25T17:16:01Z
Pulaski,4,0,4,29169,2020-03-25T17:16:01Z
Scott,1,0,1,29201,2020-03-25T17:16:01Z
St. Charles,8,1,7,29183,2020-03-25T17:16:01Z
St. Francois,2,1,1,29187,2020-03-25T17:16:01Z
St. Louis City,23,9,14,29510,2020-03-25T17:16:01Z
St. Louis,100,17,83,29189,2020-03-25T17:16:01Z
Taney,1,0,1,29213,2020-03-25T17:16:01Z
TBD,8,0,8,NA,2020-03-25T17:16:01Z
Adair,1,0,1,29001,2020-03-25T13:16:01Z
Bates,1,0,1,29013,2020-03-25T13:16:01Z
Boone,20,1,19,29019,2020-03-25T13:16:01Z
Callaway,2,0,2,29027,2020-03-25T13:16:01Z
Camden,1,1,0,29029,2020-03-25T13:16:01Z
Cass,6,2,4,29037,2020-03-25T13:16:01Z
Christian,1,1,0,29043,2020-03-25T13:16:01Z
Clay,2,0,2,29047,2020-03-25T13:16:01Z
Clinton,1,0,1,29049,2020-03-25T13:16:01Z
Cole,5,3,2,29051,2020-03-25T13:16:01Z
Dunklin,1,0,1,29069,2020-03-25T13:16:01Z
Franklin,1,0,1,29071,2020-03-25T13:16:01Z
Greene,19,12,7,29077,2020-03-25T13:16:01Z
Henry,1,1,0,29083,2020-03-25T13:16:01Z
Jackson,14,2,12,29095,2020-03-25T13:16:01Z
Jasper,1,1,0,29097,2020-03-25T13:16:01Z
Jefferson,4,1,3,29099,2020-03-25T13:16:01Z
Johnson,1,1,0,29101,2020-03-25T13:16:01Z
Kansas City,21,0,21,NA,2020-03-25T13:16:01Z
Lafayette,1,0,1,29107,2020-03-25T13:16:01Z
Moniteau,1,0,1,29135,2020-03-25T13:16:01Z
Pemiscot,1,0,1,29155,2020-03-25T13:16:01Z
Perry,2,1,1,29157,2020-03-25T13:16:01Z
Pulaski,4,0,4,29169,2020-03-25T13:16:01Z
Scott,1,0,1,29201,2020-03-25T13:16:01Z
St. Charles,8,1,7,29183,2020-03-25T13:16:01Z
St. Francois,2,1,1,29187,2020-03-25T13:16:01Z
St. Louis City,23,9,14,29510,2020-03-25T13:16:01Z
St. Louis,100,17,83,29189,2020-03-25T13:16:01Z
Taney,1,0,1,29213,2020-03-25T13:16:01Z
TBD,8,0,8,NA,2020-03-25T13:16:01Z
Adair,1,0,1,29001,2020-03-25T01:16:01Z
Bates,1,0,1,29013,2020-03-25T01:16:01Z
Boone,20,1,19,29019,2020-03-25T01:16:01Z
Callaway,2,0,2,29027,2020-03-25T01:16:01Z
Camden,1,1,0,29029,2020-03-25T01:16:01Z
Cass,6,2,4,29037,2020-03-25T01:16:01Z
Christian,1,1,0,29043,2020-03-25T01:16:01Z
Clay,2,0,2,29047,2020-03-25T01:16:01Z
Clinton,1,0,1,29049,2020-03-25T01:16:01Z
Cole,5,3,2,29051,2020-03-25T01:16:01Z
Dunklin,1,0,1,29069,2020-03-25T01:16:01Z
Franklin,1,0,1,29071,2020-03-25T01:16:01Z
Greene,19,12,7,29077,2020-03-25T01:16:01Z
Henry,1,1,0,29083,2020-03-25T01:16:01Z
Jackson,14,2,12,29095,2020-03-25T01:16:01Z
Jasper,1,1,0,29097,2020-03-25T01:16:01Z
Jefferson,4,1,3,29099,2020-03-25T01:16:01Z
Johnson,1,1,0,29101,2020-03-25T01:16:01Z
Kansas City,21,0,21,NA,2020-03-25T01:16:01Z
Lafayette,1,0,1,29107,2020-03-25T01:16:01Z
Moniteau,1,0,1,29135,2020-03-25T01:16:01Z
Pemiscot,1,0,1,29155,2020-03-25T01:16:01Z
Perry,2,1,1,29157,2020-03-25T01:16:01Z
Pulaski,4,0,4,29169,2020-03-25T01:16:01Z
Scott,1,0,1,29201,2020-03-25T01:16:01Z
St. Charles,8,1,7,29183,2020-03-25T01:16:01Z
St. Francois,2,1,1,29187,2020-03-25T01:16:01Z
St. Louis City,23,9,14,29510,2020-03-25T01:16:01Z
St. Louis,100,17,83,29189,2020-03-25T01:16:01Z
Taney,1,0,1,29213,2020-03-25T01:16:01Z
TBD,8,0,8,NA,2020-03-25T01:16:01Z
Adair,1,0,1,29001,2020-03-24T21:16:01Z
Bates,1,0,1,29013,2020-03-24T21:16:01Z
Boone,20,1,19,29019,2020-03-24T21:16:01Z
Callaway,2,0,2,29027,2020-03-24T21:16:01Z
Camden,1,1,0,29029,2020-03-24T21:16:01Z
Cass,6,2,4,29037,2020-03-24T21:16:01Z
Christian,1,1,0,29043,2020-03-24T21:16:01Z
Clay,2,0,2,29047,2020-03-24T21:16:01Z
Clinton,1,0,1,29049,2020-03-24T21:16:01Z
Cole,5,3,2,29051,2020-03-24T21:16:01Z
Dunklin,1,0,1,29069,2020-03-24T21:16:01Z
Franklin,1,0,1,29071,2020-03-24T21:16:01Z
Greene,19,12,7,29077,2020-03-24T21:16:01Z
Henry,1,1,0,29083,2020-03-24T21:16:01Z
Jackson,14,2,12,29095,2020-03-24T21:16:01Z
Jasper,1,1,0,29097,2020-03-24T21:16:01Z
Jefferson,4,1,3,29099,2020-03-24T21:16:01Z
Johnson,1,1,0,29101,2020-03-24T21:16:01Z
Kansas City,21,0,21,NA,2020-03-24T21:16:01Z
Lafayette,1,0,1,29107,2020-03-24T21:16:01Z
Moniteau,1,0,1,29135,2020-03-24T21:16:01Z
Pemiscot,1,0,1,29155,2020-03-24T21:16:01Z
Perry,2,1,1,29157,2020-03-24T21:16:01Z
Pulaski,4,0,4,29169,2020-03-24T21:16:01Z
Scott,1,0,1,29201,2020-03-24T21:16:01Z
St. Charles,8,1,7,29183,2020-03-24T21:16:01Z
St. Francois,2,1,1,29187,2020-03-24T21:16:01Z
St. Louis City,23,9,14,29510,2020-03-24T21:16:01Z
St. Louis,100,17,83,29189,2020-03-24T21:16:01Z
Taney,1,0,1,29213,2020-03-24T21:16:01Z
TBD,8,0,8,NA,2020-03-24T21:16:01Z
Adair,2,0,2,29001,2020-03-24T17:16:01Z
Bates,1,0,1,29013,2020-03-24T17:16:01Z
Boone,17,1,16,29019,2020-03-24T17:16:01Z
Callaway,1,0,1,29027,2020-03-24T17:16:01Z
Camden,1,1,0,29029,2020-03-24T17:16:01Z
Cass,6,2,4,29037,2020-03-24T17:16:01Z
Christian,1,1,0,29043,2020-03-24T17:16:01Z
Clinton,1,0,1,29049,2020-03-24T17:16:01Z
Cole,5,3,2,29051,2020-03-24T17:16:01Z
Dunklin,1,0,1,29069,2020-03-24T17:16:01Z
Greene,16,11,5,29077,2020-03-24T17:16:01Z
Henry,1,1,0,29083,2020-03-24T17:16:01Z
Jackson,10,2,8,29095,2020-03-24T17:16:01Z
Jasper,1,1,0,29097,2020-03-24T17:16:01Z
Johnson,1,1,0,29101,2020-03-24T17:16:01Z
Kansas City,17,0,17,NA,2020-03-24T17:16:01Z
Lafayette,1,0,1,29107,2020-03-24T17:16:01Z
Moniteau,1,0,1,29135,2020-03-24T17:16:01Z
Perry,1,0,1,29157,2020-03-24T17:16:01Z
Pulaski,1,0,1,29169,2020-03-24T17:16:01Z
Scott,1,0,1,29201,2020-03-24T17:16:01Z
St. Charles,4,1,3,29183,2020-03-24T17:16:01Z
St. Francois,1,1,0,29187,2020-03-24T17:16:01Z
St. Louis City,15,7,8,29510,2020-03-24T17:16:01Z
St. Louis,69,14,55,29189,2020-03-24T17:16:01Z
Taney,1,0,1,29213,2020-03-24T17:16:01Z
TBD,6,0,6,NA,2020-03-24T17:16:01Z
Adair,2,0,2,29001,2020-03-24T13:16:02Z
Bates,1,0,1,29013,2020-03-24T13:16:02Z
Boone,17,1,16,29019,2020-03-24T13:16:02Z
Callaway,1,0,1,29027,2020-03-24T13:16:02Z
Camden,1,1,0,29029,2020-03-24T13:16:02Z
Cass,6,2,4,29037,2020-03-24T13:16:02Z
Christian,1,1,0,29043,2020-03-24T13:16:02Z
Clinton,1,0,1,29049,2020-03-24T13:16:02Z
Cole,5,3,2,29051,2020-03-24T13:16:02Z
Dunklin,1,0,1,29069,2020-03-24T13:16:02Z
Greene,16,11,5,29077,2020-03-24T13:16:02Z
Henry,1,1,0,29083,2020-03-24T13:16:02Z
Jackson,10,2,8,29095,2020-03-24T13:16:02Z
Jasper,1,1,0,29097,2020-03-24T13:16:02Z
Johnson,1,1,0,29101,2020-03-24T13:16:02Z
Kansas City,17,0,17,NA,2020-03-24T13:16:02Z
Lafayette,1,0,1,29107,2020-03-24T13:16:02Z
Moniteau,1,0,1,29135,2020-03-24T13:16:02Z
Perry,1,0,1,29157,2020-03-24T13:16:02Z
Pulaski,1,0,1,29169,2020-03-24T13:16:02Z
Scott,1,0,1,29201,2020-03-24T13:16:02Z
St. Charles,4,1,3,29183,2020-03-24T13:16:02Z
St. Francois,1,1,0,29187,2020-03-24T13:16:02Z
St. Louis City,15,7,8,29510,2020-03-24T13:16:02Z
St. Louis,69,14,55,29189,2020-03-24T13:16:02Z
Taney,1,0,1,29213,2020-03-24T13:16:02Z
TBD,6,0,6,NA,2020-03-24T13:16:02Z
Adair,2,0,2,29001,2020-03-24T01:16:01Z
Bates,1,0,1,29013,2020-03-24T01:16:01Z
Boone,17,1,16,29019,2020-03-24T01:16:01Z
Callaway,1,0,1,29027,2020-03-24T01:16:01Z
Camden,1,1,0,29029,2020-03-24T01:16:01Z
Cass,6,2,4,29037,2020-03-24T01:16:01Z
Christian,1,1,0,29043,2020-03-24T01:16:01Z
Clinton,1,0,1,29049,2020-03-24T01:16:01Z
Cole,5,3,2,29051,2020-03-24T01:16:01Z
Dunklin,1,0,1,29069,2020-03-24T01:16:01Z
Greene,16,11,5,29077,2020-03-24T01:16:01Z
Henry,1,1,0,29083,2020-03-24T01:16:01Z
Jackson,10,2,8,29095,2020-03-24T01:16:01Z
Jasper,1,1,0,29097,2020-03-24T01:16:01Z
Johnson,1,1,0,29101,2020-03-24T01:16:01Z
Kansas City,17,0,17,NA,2020-03-24T01:16:01Z
Lafayette,1,0,1,29107,2020-03-24T01:16:01Z
Moniteau,1,0,1,29135,2020-03-24T01:16:01Z
Perry,1,0,1,29157,2020-03-24T01:16:01Z
Pulaski,1,0,1,29169,2020-03-24T01:16:01Z
Scott,1,0,1,29201,2020-03-24T01:16:01Z
St. Charles,4,1,3,29183,2020-03-24T01:16:01Z
St. Francois,1,1,0,29187,2020-03-24T01:16:01Z
St. Louis City,15,7,8,29510,2020-03-24T01:16:01Z
St. Louis,69,14,55,29189,2020-03-24T01:16:01Z
Taney,1,0,1,29213,2020-03-24T01:16:01Z
TBD,6,0,6,NA,2020-03-24T01:16:01Z
Adair,2,0,2,29001,2020-03-23T21:16:01Z
Bates,1,0,1,29013,2020-03-23T21:16:01Z
Boone,17,1,16,29019,2020-03-23T21:16:01Z
Callaway,1,0,1,29027,2020-03-23T21:16:01Z
Camden,1,1,0,29029,2020-03-23T21:16:01Z
Cass,6,2,4,29037,2020-03-23T21:16:01Z
Christian,1,1,0,29043,2020-03-23T21:16:01Z
Clinton,1,0,1,29049,2020-03-23T21:16:01Z
Cole,5,3,2,29051,2020-03-23T21:16:01Z
Dunklin,1,0,1,29069,2020-03-23T21:16:01Z
Greene,16,11,5,29077,2020-03-23T21:16:01Z
Henry,1,1,0,29083,2020-03-23T21:16:01Z
Jackson,10,2,8,29095,2020-03-23T21:16:01Z
Jasper,1,1,0,29097,2020-03-23T21:16:01Z
Johnson,1,1,0,29101,2020-03-23T21:16:01Z
Kansas City,17,0,17,NA,2020-03-23T21:16:01Z
Lafayette,1,0,1,29107,2020-03-23T21:16:01Z
Moniteau,1,0,1,29135,2020-03-23T21:16:01Z
Perry,1,0,1,29157,2020-03-23T21:16:01Z
Pulaski,1,0,1,29169,2020-03-23T21:16:01Z
Scott,1,0,1,29201,2020-03-23T21:16:01Z
St. Charles,4,1,3,29183,2020-03-23T21:16:01Z
St. Francois,1,1,0,29187,2020-03-23T21:16:01Z
St. Louis City,15,7,8,29510,2020-03-23T21:16:01Z
St. Louis,69,14,55,29189,2020-03-23T21:16:01Z
Taney,1,0,1,29213,2020-03-23T21:16:01Z
TBD,6,0,6,NA,2020-03-23T21:16:01Z
Adair,1,0,1,29001,2020-03-23T17:16:01Z
Bates,1,0,1,29013,2020-03-23T17:16:01Z
Boone,10,1,9,29019,2020-03-23T17:16:01Z
Camden,1,1,0,29029,2020-03-23T17:16:01Z
Cass,6,2,4,29037,2020-03-23T17:16:01Z
Christian,1,1,0,29043,2020-03-23T17:16:01Z
Cole,4,3,1,29051,2020-03-23T17:16:01Z
Dunklin,1,0,1,29069,2020-03-23T17:16:01Z
Greene,14,11,3,29077,2020-03-23T17:16:01Z
Henry,1,1,0,29083,2020-03-23T17:16:01Z
Jackson,6,2,4,29095,2020-03-23T17:16:01Z
Jasper,1,1,0,29097,2020-03-23T17:16:01Z
Johnson,1,1,0,29101,2020-03-23T17:16:01Z
Kansas City,13,0,13,NA,2020-03-23T17:16:01Z
Moniteau,1,0,1,29135,2020-03-23T17:16:01Z
Perry,1,0,1,29157,2020-03-23T17:16:01Z
Pulaski,1,0,1,29169,2020-03-23T17:16:01Z
Scott,1,0,1,29201,2020-03-23T17:16:01Z
St. Charles,2,1,1,29183,2020-03-23T17:16:01Z
St. Francois,1,1,0,29187,2020-03-23T17:16:01Z
St. Louis City,10,7,3,29510,2020-03-23T17:16:01Z
St. Louis,23,14,9,29189,2020-03-23T17:16:01Z
TBD,5,0,5,NA,2020-03-23T17:16:01Z
Adair,1,0,1,29001,2020-03-23T13:16:01Z
Bates,1,0,1,29013,2020-03-23T13:16:01Z
Boone,10,1,9,29019,2020-03-23T13:16:01Z
Camden,1,1,0,29029,2020-03-23T13:16:01Z
Cass,6,2,4,29037,2020-03-23T13:16:01Z
Christian,1,1,0,29043,2020-03-23T13:16:01Z
Cole,4,3,1,29051,2020-03-23T13:16:01Z
Dunklin,1,0,1,29069,2020-03-23T13:16:01Z
Greene,14,11,3,29077,2020-03-23T13:16:01Z
Henry,1,1,0,29083,2020-03-23T13:16:01Z
Jackson,6,2,4,29095,2020-03-23T13:16:01Z
Jasper,1,1,0,29097,2020-03-23T13:16:01Z
Johnson,1,1,0,29101,2020-03-23T13:16:01Z
Kansas City,13,0,13,NA,2020-03-23T13:16:01Z
Moniteau,1,0,1,29135,2020-03-23T13:16:01Z
Perry,1,0,1,29157,2020-03-23T13:16:01Z
Pulaski,1,0,1,29169,2020-03-23T13:16:01Z
Scott,1,0,1,29201,2020-03-23T13:16:01Z
St. Charles,2,1,1,29183,2020-03-23T13:16:01Z
St. Francois,1,1,0,29187,2020-03-23T13:16:01Z
St. Louis City,10,7,3,29510,2020-03-23T13:16:01Z
St. Louis,23,14,9,29189,2020-03-23T13:16:01Z
TBD,5,0,5,NA,2020-03-23T13:16:01Z
Bates,1,0,1,29013,2020-03-23T01:16:01Z
Boone,10,1,9,29019,2020-03-23T01:16:01Z
Cass,6,2,4,29037,2020-03-23T01:16:01Z
Christian,1,1,0,29043,2020-03-23T01:16:01Z
Cole,3,2,1,29051,2020-03-23T01:16:01Z
Dunklin,1,0,1,29069,2020-03-23T01:16:01Z
Greene,10,8,2,29077,2020-03-23T01:16:01Z
Henry,1,1,0,29083,2020-03-23T01:16:01Z
Jackson,5,1,4,29095,2020-03-23T01:16:01Z
Jasper,1,1,0,29097,2020-03-23T01:16:01Z
Johnson,1,1,0,29101,2020-03-23T01:16:01Z
Kansas City,13,0,13,NA,2020-03-23T01:16:01Z
Pulaski,1,0,1,29169,2020-03-23T01:16:01Z
Scott,1,0,1,29201,2020-03-23T01:16:01Z
St. Charles,2,1,1,29183,2020-03-23T01:16:01Z
St. Louis City,7,5,2,29510,2020-03-23T01:16:01Z
St. Louis,22,14,8,29189,2020-03-23T01:16:01Z
TBD,4,0,4,NA,2020-03-23T01:16:01Z
Bates,1,0,1,29013,2020-03-22T23:48:28Z
Boone,10,1,9,29019,2020-03-22T23:48:28Z
Cass,6,2,4,29037,2020-03-22T23:48:28Z
Christian,1,1,0,29043,2020-03-22T23:48:28Z
Cole,3,2,1,29051,2020-03-22T23:48:28Z
Dunklin,1,0,1,29069,2020-03-22T23:48:28Z
Greene,10,8,2,29077,2020-03-22T23:48:28Z
Henry,1,1,0,29083,2020-03-22T23:48:28Z
Jackson,5,1,4,29095,2020-03-22T23:48:28Z
Jasper,1,1,0,29097,2020-03-22T23:48:28Z
Johnson,1,1,0,29101,2020-03-22T23:48:28Z
Kansas City,13,0,13,NA,2020-03-22T23:48:28Z
Pulaski,1,0,1,29169,2020-03-22T23:48:28Z
Scott,1,0,1,29201,2020-03-22T23:48:28Z
St. Charles,2,1,1,29183,2020-03-22T23:48:28Z
St. Louis City,7,5,2,29510,2020-03-22T23:48:28Z
St. Louis,22,14,8,29189,2020-03-22T23:48:28Z
TBD,4,0,4,NA,2020-03-22T23:48:28Z
Bates,1,0,1,29013,2020-03-22T23:45:21Z
Boone,10,1,9,29019,2020-03-22T23:45:21Z
Cass,6,2,4,29037,2020-03-22T23:45:21Z
Christian,1,1,0,29043,2020-03-22T23:45:21Z
Cole,3,2,1,29051,2020-03-22T23:45:21Z
Dunklin,1,0,1,29069,2020-03-22T23:45:21Z
Greene,10,8,2,29077,2020-03-22T23:45:21Z
Henry,1,1,0,29083,2020-03-22T23:45:21Z
Jackson,5,1,4,29095,2020-03-22T23:45:21Z
Jasper,1,1,0,29097,2020-03-22T23:45:21Z
Johnson,1,1,0,29101,2020-03-22T23:45:21Z
Kansas City,13,0,13,NA,2020-03-22T23:45:21Z
Pulaski,1,0,1,29169,2020-03-22T23:45:21Z
Scott,1,0,1,29201,2020-03-22T23:45:21Z
St. Charles,2,1,1,29183,2020-03-22T23:45:21Z
St. Louis City,7,5,2,29510,2020-03-22T23:45:21Z
St. Louis,22,14,8,29189,2020-03-22T23:45:21Z
TBD,4,0,4,NA,2020-03-22T23:45:21Z
Bates,1,0,1,29013,2020-03-22T23:42:33Z
Boone,10,1,9,29019,2020-03-22T23:42:33Z
Cass,6,2,4,29037,2020-03-22T23:42:33Z
Christian,1,1,0,29043,2020-03-22T23:42:33Z
Cole,3,2,1,29051,2020-03-22T23:42:33Z
Dunklin,1,0,1,29069,2020-03-22T23:42:33Z
Greene,10,8,2,29077,2020-03-22T23:42:33Z
Henry,1,1,0,29083,2020-03-22T23:42:33Z
Jackson,5,1,4,29095,2020-03-22T23:42:33Z
Jasper,1,1,0,29097,2020-03-22T23:42:33Z
Johnson,1,1,0,29101,2020-03-22T23:42:33Z
Kansas City,13,0,13,NA,2020-03-22T23:42:33Z
Pulaski,1,0,1,29169,2020-03-22T23:42:33Z
Scott,1,0,1,29201,2020-03-22T23:42:33Z
St. Charles,2,1,1,29183,2020-03-22T23:42:33Z
St. Louis City,7,5,2,29510,2020-03-22T23:42:33Z
St. Louis,22,14,8,29189,2020-03-22T23:42:33Z
TBD,4,0,4,NA,2020-03-22T23:42:33Z
Bates,1,0,1,29013,2020-03-22T21:16:01Z
Boone,10,1,9,29019,2020-03-22T21:16:01Z
Cass,6,2,4,29037,2020-03-22T21:16:01Z
Christian,1,1,0,29043,2020-03-22T21:16:01Z
Cole,3,2,1,29051,2020-03-22T21:16:01Z
Dunklin,1,0,1,29069,2020-03-22T21:16:01Z
Greene,10,8,2,29077,2020-03-22T21:16:01Z
Henry,1,1,0,29083,2020-03-22T21:16:01Z
Jackson,5,1,4,29095,2020-03-22T21:16:01Z
Jasper,1,1,0,29097,2020-03-22T21:16:01Z
Johnson,1,1,0,29101,2020-03-22T21:16:01Z
Kansas City,13,0,13,NA,2020-03-22T21:16:01Z
Pulaski,1,0,1,29169,2020-03-22T21:16:01Z
Scott,1,0,1,29201,2020-03-22T21:16:01Z
St. Charles,2,1,1,29183,2020-03-22T21:16:01Z
St. Louis City,7,5,2,29510,2020-03-22T21:16:01Z
St. Louis,22,14,8,29189,2020-03-22T21:16:01Z
TBD,4,0,4,NA,2020-03-22T21:16:01Z
Bates,1,0,1,29013,2020-03-22T19:37:50Z
Boone,10,1,9,29019,2020-03-22T19:37:50Z
Cass,6,2,4,29037,2020-03-22T19:37:50Z
Christian,1,1,0,29043,2020-03-22T19:37:50Z
Cole,3,2,1,29051,2020-03-22T19:37:50Z
Dunklin,1,0,1,29069,2020-03-22T19:37:50Z
Greene,10,8,2,29077,2020-03-22T19:37:50Z
Henry,1,1,0,29083,2020-03-22T19:37:50Z
Jackson,5,1,4,29095,2020-03-22T19:37:50Z
Jasper,1,1,0,29097,2020-03-22T19:37:50Z
Johnson,1,1,0,29101,2020-03-22T19:37:50Z
Kansas City,13,0,13,NA,2020-03-22T19:37:50Z
Pulaski,1,0,1,29169,2020-03-22T19:37:50Z
Scott,1,0,1,29201,2020-03-22T19:37:50Z
St. Charles,2,1,1,29183,2020-03-22T19:37:50Z
St. Louis City,7,5,2,29510,2020-03-22T19:37:50Z
St. Louis,22,14,8,29189,2020-03-22T19:37:50Z
TBD,4,0,4,NA,2020-03-22T19:37:50Z
Bates,1,0,1,29013,2020-03-22T19:36:48Z
Boone,10,1,9,29019,2020-03-22T19:36:48Z
Cass,6,2,4,29037,2020-03-22T19:36:48Z
Christian,1,1,0,29043,2020-03-22T19:36:48Z
Cole,3,2,1,29051,2020-03-22T19:36:48Z
Dunklin,1,0,1,29069,2020-03-22T19:36:48Z
Greene,10,8,2,29077,2020-03-22T19:36:48Z
Henry,1,1,0,29083,2020-03-22T19:36:48Z
Jackson,5,1,4,29095,2020-03-22T19:36:48Z
Jasper,1,1,0,29097,2020-03-22T19:36:48Z
Johnson,1,1,0,29101,2020-03-22T19:36:48Z
Kansas City,13,0,13,NA,2020-03-22T19:36:48Z
Pulaski,1,0,1,29169,2020-03-22T19:36:48Z
Scott,1,0,1,29201,2020-03-22T19:36:48Z
St. Charles,2,1,1,29183,2020-03-22T19:36:48Z
St. Louis City,7,5,2,29510,2020-03-22T19:36:48Z
St. Louis,22,14,8,29189,2020-03-22T19:36:48Z
TBD,4,0,4,NA,2020-03-22T19:36:48Z
Bates,1,0,1,29013,2020-03-22T19:35:24Z
Boone,10,1,9,29019,2020-03-22T19:35:24Z
Cass,6,2,4,29037,2020-03-22T19:35:24Z
Christian,1,1,0,29043,2020-03-22T19:35:24Z
Cole,3,2,1,29051,2020-03-22T19:35:24Z
Dunklin,1,0,1,29069,2020-03-22T19:35:24Z
Greene,10,8,2,29077,2020-03-22T19:35:24Z
Henry,1,1,0,29083,2020-03-22T19:35:24Z
Jackson,5,1,4,29095,2020-03-22T19:35:24Z
Jasper,1,1,0,29097,2020-03-22T19:35:24Z
Johnson,1,1,0,29101,2020-03-22T19:35:24Z
Kansas City,13,0,13,NA,2020-03-22T19:35:24Z
Pulaski,1,0,1,29169,2020-03-22T19:35:24Z
Scott,1,0,1,29201,2020-03-22T19:35:24Z
St. Charles,2,1,1,29183,2020-03-22T19:35:24Z
St. Louis City,7,5,2,29510,2020-03-22T19:35:24Z
St. Louis,22,14,8,29189,2020-03-22T19:35:24Z
TBD,4,0,4,NA,2020-03-22T19:35:24Z
Bates,1,0,1,29013,2020-03-22T19:33:15Z
Boone,10,1,9,29019,2020-03-22T19:33:15Z
Cass,6,2,4,29037,2020-03-22T19:33:15Z
Christian,1,1,0,29043,2020-03-22T19:33:15Z
Cole,3,2,1,29051,2020-03-22T19:33:15Z
Dunklin,1,0,1,29069,2020-03-22T19:33:15Z
Greene,10,8,2,29077,2020-03-22T19:33:15Z
Henry,1,1,0,29083,2020-03-22T19:33:15Z
Jackson,5,1,4,29095,2020-03-22T19:33:15Z
Jasper,1,1,0,29097,2020-03-22T19:33:15Z
Johnson,1,1,0,29101,2020-03-22T19:33:15Z
Kansas City,13,0,13,NA,2020-03-22T19:33:15Z
Pulaski,1,0,1,29169,2020-03-22T19:33:15Z
Scott,1,0,1,29201,2020-03-22T19:33:15Z
St. Charles,2,1,1,29183,2020-03-22T19:33:15Z
St. Louis City,7,5,2,29510,2020-03-22T19:33:15Z
St. Louis,22,14,8,29189,2020-03-22T19:33:15Z
TBD,4,0,4,NA,2020-03-22T19:33:15Z
Bates,1,0,1,29013,2020-03-22T19:31:40Z
Boone,10,1,9,29019,2020-03-22T19:31:40Z
Cass,6,2,4,29037,2020-03-22T19:31:40Z
Christian,1,1,0,29043,2020-03-22T19:31:40Z
Cole,3,2,1,29051,2020-03-22T19:31:40Z
Dunklin,1,0,1,29069,2020-03-22T19:31:40Z
Greene,10,8,2,29077,2020-03-22T19:31:40Z
Henry,1,1,0,29083,2020-03-22T19:31:40Z
Jackson,5,1,4,29095,2020-03-22T19:31:40Z
Jasper,1,1,0,29097,2020-03-22T19:31:40Z
Johnson,1,1,0,29101,2020-03-22T19:31:40Z
Kansas City,13,0,13,NA,2020-03-22T19:31:40Z
Pulaski,1,0,1,29169,2020-03-22T19:31:40Z
Scott,1,0,1,29201,2020-03-22T19:31:40Z
St. Charles,2,1,1,29183,2020-03-22T19:31:40Z
St. Louis City,7,5,2,29510,2020-03-22T19:31:40Z
St. Louis,22,14,8,29189,2020-03-22T19:31:40Z
TBD,4,0,4,NA,2020-03-22T19:31:40Z
Bates,1,0,1,29013,2020-03-22T19:18:00Z
Boone,10,1,9,29019,2020-03-22T19:18:00Z
Cass,6,2,4,29037,2020-03-22T19:18:00Z
Christian,1,1,0,29043,2020-03-22T19:18:00Z
Cole,3,2,1,29051,2020-03-22T19:18:00Z
Dunklin,1,0,1,29069,2020-03-22T19:18:00Z
Greene,10,8,2,29077,2020-03-22T19:18:00Z
Henry,1,1,0,29083,2020-03-22T19:18:00Z
Jackson,5,1,4,29095,2020-03-22T19:18:00Z
Jasper,1,1,0,29097,2020-03-22T19:18:00Z
Johnson,1,1,0,29101,2020-03-22T19:18:00Z
Kansas City,13,0,13,NA,2020-03-22T19:18:00Z
Pulaski,1,0,1,29169,2020-03-22T19:18:00Z
Scott,1,0,1,29201,2020-03-22T19:18:00Z
St. Charles,2,1,1,29183,2020-03-22T19:18:00Z
St. Louis City,7,5,2,29510,2020-03-22T19:18:00Z
St. Louis,22,14,8,29189,2020-03-22T19:18:00Z
TBD,4,0,4,NA,2020-03-22T19:18:00Z
Bates,1,0,1,29013,2020-03-22T19:07:23Z
Boone,10,1,9,29019,2020-03-22T19:07:23Z
Cass,6,2,4,29037,2020-03-22T19:07:23Z
Christian,1,1,0,29043,2020-03-22T19:07:23Z
Cole,3,2,1,29051,2020-03-22T19:07:23Z
Dunklin,1,0,1,29069,2020-03-22T19:07:23Z
Greene,10,8,2,29077,2020-03-22T19:07:23Z
Henry,1,1,0,29083,2020-03-22T19:07:23Z
Jackson,5,1,4,29095,2020-03-22T19:07:23Z
Jasper,1,1,0,29097,2020-03-22T19:07:23Z
Johnson,1,1,0,29101,2020-03-22T19:07:23Z
Kansas City,13,0,13,NA,2020-03-22T19:07:23Z
Pulaski,1,0,1,29169,2020-03-22T19:07:23Z
Scott,1,0,1,29201,2020-03-22T19:07:23Z
St. Charles,2,1,1,29183,2020-03-22T19:07:23Z
St. Louis City,7,5,2,29510,2020-03-22T19:07:23Z
St. Louis,22,14,8,29189,2020-03-22T19:07:23Z
TBD,4,0,4,NA,2020-03-22T19:07:23Z
